NOM_ENT,Grupo quinquenal de edad,AÑO,Total,Hombres,Mujeres
Aguascalientes,No especificado,1990,2245,1084,1161
Aguascalientes,No especificado,1995,1254,607,647
Aguascalientes,No especificado,2000,102,44,58
Aguascalientes,No especificado,2005,98,41,57
Aguascalientes,No especificado,2010,109,45,64
Aguascalientes,No especificado,2020,1508,749,759
Aguascalientes,95 a 99 años,1990,237,81,156
Aguascalientes,95 a 99 años,1995,380,154,226
Aguascalientes,95 a 99 años,2000,1169,466,703
Aguascalientes,95 a 99 años,2005,1302,542,760
Aguascalientes,95 a 99 años,2010,1467,605,862
Aguascalientes,95 a 99 años,2020,796,284,512
Aguascalientes,90 a 94 años,1990,715,295,420
Aguascalientes,90 a 94 años,1995,975,409,566
Aguascalientes,90 a 94 años,2000,2726,1185,1541
Aguascalientes,90 a 94 años,2005,3140,1384,1756
Aguascalientes,90 a 94 años,2010,4061,1780,2281
Aguascalientes,90 a 94 años,2020,2410,942,1468
Aguascalientes,85 a 89 años,1990,2221,978,1243
Aguascalientes,85 a 89 años,1995,2428,1063,1365
Aguascalientes,85 a 89 años,2000,4336,1915,2421
Aguascalientes,85 a 89 años,2005,6155,2668,3487
Aguascalientes,85 a 89 años,2010,7228,3094,4134
Aguascalientes,85 a 89 años,2020,5576,2360,3216
Aguascalientes,80 a 84 años,1990,3661,1622,2039
Aguascalientes,80 a 84 años,1995,3892,1776,2116
Aguascalientes,80 a 84 años,2000,7754,3648,4106
Aguascalientes,80 a 84 años,2005,9203,4193,5010
Aguascalientes,80 a 84 años,2010,10673,4862,5811
Aguascalientes,80 a 84 años,2020,10186,4397,5789
Aguascalientes,75 a 79 años,1990,5378,2540,2838
Aguascalientes,75 a 79 años,1995,5771,2738,3033
Aguascalientes,75 a 79 años,2000,10714,4901,5813
Aguascalientes,75 a 79 años,2005,12912,5935,6977
Aguascalientes,75 a 79 años,2010,15254,6967,8287
Aguascalientes,75 a 79 años,2020,16581,7739,8842
Aguascalientes,70 a 74 años,1990,6731,3191,3540
Aguascalientes,70 a 74 años,1995,9452,4438,5014
Aguascalientes,70 a 74 años,2000,13752,6333,7419
Aguascalientes,70 a 74 años,2005,16290,7509,8781
Aguascalientes,70 a 74 años,2010,21004,9895,11109
Aguascalientes,70 a 74 años,2020,25586,11782,13804
Aguascalientes,65 a 69 años,1990,10091,4755,5336
Aguascalientes,65 a 69 años,1995,11870,5412,6458
Aguascalientes,65 a 69 años,2000,17759,8129,9630
Aguascalientes,65 a 69 años,2005,23168,10959,12209
Aguascalientes,65 a 69 años,2010,29258,13686,15572
Aguascalientes,65 a 69 años,2020,35823,16698,19125
Aguascalientes,60 a 64 años,1990,13035,6059,6976
Aguascalientes,60 a 64 años,1995,15900,7378,8522
Aguascalientes,60 a 64 años,2000,22094,10638,11456
Aguascalientes,60 a 64 años,2005,29196,13802,15394
Aguascalientes,60 a 64 años,2010,37543,17960,19583
Aguascalientes,60 a 64 años,2020,48306,22435,25871
Aguascalientes,55 a 59 años,1990,14905,7045,7860
Aguascalientes,55 a 59 años,1995,17646,8436,9210
Aguascalientes,55 a 59 años,2000,30202,14400,15802
Aguascalientes,55 a 59 años,2005,39222,18636,20586
Aguascalientes,55 a 59 años,2010,49980,23436,26544
Aguascalientes,55 a 59 años,2020,58865,27608,31257
Aguascalientes,50 a 54 años,1990,18093,8523,9570
Aguascalientes,50 a 54 años,1995,24525,11930,12595
Aguascalientes,50 a 54 años,2000,37541,17855,19686
Aguascalientes,50 a 54 años,2005,49233,23155,26078
Aguascalientes,50 a 54 años,2010,60198,28420,31778
Aguascalientes,50 a 54 años,2020,74121,34611,39510
Aguascalientes,5 a 9 años,1990,98158,49742,48416
Aguascalientes,5 a 9 años,1995,107680,54663,53017
Aguascalientes,5 a 9 años,2000,116137,58831,57306
Aguascalientes,5 a 9 años,2005,118536,60406,58130
Aguascalientes,5 a 9 años,2010,121557,61941,59616
Aguascalientes,5 a 9 años,2020,131048,66359,64689
Aguascalientes,45 a 49 años,1990,23788,11650,12138
Aguascalientes,45 a 49 años,1995,31678,15260,16418
Aguascalientes,45 a 49 años,2000,49365,23383,25982
Aguascalientes,45 a 49 años,2005,61553,29044,32509
Aguascalientes,45 a 49 años,2010,73084,34381,38703
Aguascalientes,45 a 49 años,2020,84669,40163,44506
Aguascalientes,40 a 44 años,1990,29392,13962,15430
Aguascalientes,40 a 44 años,1995,40131,19467,20664
Aguascalientes,40 a 44 años,2000,60839,28736,32103
Aguascalientes,40 a 44 años,2005,73006,34068,38938
Aguascalientes,40 a 44 años,2010,86254,40569,45685
Aguascalientes,40 a 44 años,2020,92378,43839,48539
Aguascalientes,35 a 39 años,1990,38127,18255,19872
Aguascalientes,35 a 39 años,1995,52549,25116,27433
Aguascalientes,35 a 39 años,2000,70317,32438,37879
Aguascalientes,35 a 39 años,2005,82651,38373,44278
Aguascalientes,35 a 39 años,2010,88726,41962,46764
Aguascalientes,35 a 39 años,2020,99257,47774,51483
Aguascalientes,30 a 34 años,1990,46833,21920,24913
Aguascalientes,30 a 34 años,1995,62217,29478,32739
Aguascalientes,30 a 34 años,2000,79200,36461,42739
Aguascalientes,30 a 34 años,2005,83073,38437,44636
Aguascalientes,30 a 34 años,2010,93604,44568,49036
Aguascalientes,30 a 34 años,2020,106825,51651,55174
Aguascalientes,25 a 29 años,1990,55660,26182,29478
Aguascalientes,25 a 29 años,1995,71839,33658,38181
Aguascalientes,25 a 29 años,2000,87508,40526,46982
Aguascalientes,25 a 29 años,2005,93139,43716,49423
Aguascalientes,25 a 29 años,2010,106305,51431,54874
Aguascalientes,25 a 29 años,2020,118426,58141,60285
Aguascalientes,20 a 24 años,1990,69577,32248,37329
Aguascalientes,20 a 24 años,1995,88901,42402,46499
Aguascalientes,20 a 24 años,2000,99577,48733,50844
Aguascalientes,20 a 24 años,2005,107007,52748,54259
Aguascalientes,20 a 24 años,2010,121428,60636,60792
Aguascalientes,20 a 24 años,2020,127020,63154,63866
Aguascalientes,15 a 19 años,1990,87750,42735,45015
Aguascalientes,15 a 19 años,1995,97061,48025,49036
Aguascalientes,15 a 19 años,2000,108532,54930,53602
Aguascalientes,15 a 19 años,2005,120280,60816,59464
Aguascalientes,15 a 19 años,2010,123806,62615,61191
Aguascalientes,15 a 19 años,2020,131967,66903,65064
Aguascalientes,100 años y más,1990,78,24,54
Aguascalientes,100 años y más,1995,59,17,42
Aguascalientes,100 años y más,2000,542,241,301
Aguascalientes,100 años y más,2005,503,197,306
Aguascalientes,100 años y más,2010,551,229,322
Aguascalientes,100 años y más,2020,112,36,76
Aguascalientes,10 a 14 años,1990,94971,47751,47220
Aguascalientes,10 a 14 años,1995,104083,52977,51106
Aguascalientes,10 a 14 años,2000,117375,59375,58000
Aguascalientes,10 a 14 años,2005,120130,60900,59230
Aguascalientes,10 a 14 años,2010,128874,65572,63302
Aguascalientes,10 a 14 años,2020,129717,66080,63637
Aguascalientes,0 a 4 años,1990,98013,49576,48437
Aguascalientes,0 a 4 años,1995,112429,56920,55509
Aguascalientes,0 a 4 años,2000,944285,456533,487752
Aguascalientes,0 a 4 años,2005,1065416,515364,550052
Aguascalientes,0 a 4 años,2010,1184996,576638,608358
Aguascalientes,0 a 4 años,2020,124430,62978,61452
Baja California,No especificado,1990,32223,16131,16092
Baja California,No especificado,1995,10016,5098,4918
Baja California,No especificado,2000,266,114,152
Baja California,No especificado,2005,172,58,114
Baja California,No especificado,2010,206,57,149
Baja California,No especificado,2020,8219,4096,4123
Baja California,95 a 99 años,1990,412,158,254
Baja California,95 a 99 años,1995,572,228,344
Baja California,95 a 99 años,2000,1675,694,981
Baja California,95 a 99 años,2005,1987,717,1270
Baja California,95 a 99 años,2010,2641,1079,1562
Baja California,95 a 99 años,2020,1512,522,990
Baja California,90 a 94 años,1990,1027,419,608
Baja California,90 a 94 años,1995,1336,530,806
Baja California,90 a 94 años,2000,4322,1706,2616
Baja California,90 a 94 años,2005,5453,2363,3090
Baja California,90 a 94 años,2010,7764,3360,4404
Baja California,90 a 94 años,2020,4858,1897,2961
Baja California,85 a 89 años,1990,2939,1224,1715
Baja California,85 a 89 años,1995,3702,1516,2186
Baja California,85 a 89 años,2000,8005,3666,4339
Baja California,85 a 89 años,2005,11375,5240,6135
Baja California,85 a 89 años,2010,14744,6578,8166
Baja California,85 a 89 años,2020,12451,5277,7174
Baja California,80 a 84 años,1990,5456,2350,3106
Baja California,80 a 84 años,1995,7248,3211,4037
Baja California,80 a 84 años,2000,15403,7530,7873
Baja California,80 a 84 años,2005,18815,8983,9832
Baja California,80 a 84 años,2010,24055,11223,12832
Baja California,80 a 84 años,2020,25204,11060,14144
Baja California,75 a 79 años,1990,9438,4417,5021
Baja California,75 a 79 años,1995,12270,6068,6202
Baja California,75 a 79 años,2000,23192,11386,11806
Baja California,75 a 79 años,2005,28923,13866,15057
Baja California,75 a 79 años,2010,37742,17956,19786
Baja California,75 a 79 años,2020,40874,18833,22041
Baja California,70 a 74 años,1990,14420,7171,7249
Baja California,70 a 74 años,1995,21048,10598,10450
Baja California,70 a 74 años,2000,32561,15643,16918
Baja California,70 a 74 años,2005,40660,19468,21192
Baja California,70 a 74 años,2010,52560,25086,27474
Baja California,70 a 74 años,2020,65425,30812,34613
Baja California,65 a 69 años,1990,22752,11514,11238
Baja California,65 a 69 años,1995,29724,14528,15196
Baja California,65 a 69 años,2000,44174,21414,22760
Baja California,65 a 69 años,2005,56711,27276,29435
Baja California,65 a 69 años,2010,75229,36151,39078
Baja California,65 a 69 años,2020,94704,44982,49722
Baja California,60 a 64 años,1990,30769,15152,15617
Baja California,60 a 64 años,1995,40558,19816,20742
Baja California,60 a 64 años,2000,53639,26116,27523
Baja California,60 a 64 años,2005,71624,35077,36547
Baja California,60 a 64 años,2010,97874,48250,49624
Baja California,60 a 64 años,2020,134022,65287,68735
Baja California,55 a 59 años,1990,37179,18425,18754
Baja California,55 a 59 años,1995,47838,23550,24288
Baja California,55 a 59 años,2000,73548,36227,37321
Baja California,55 a 59 años,2005,99356,49179,50177
Baja California,55 a 59 años,2010,136690,68093,68597
Baja California,55 a 59 años,2020,168653,84778,83875
Baja California,50 a 54 años,1990,47458,23536,23922
Baja California,50 a 54 años,1995,64059,31978,32081
Baja California,50 a 54 años,2000,92839,46040,46799
Baja California,50 a 54 años,2005,128512,64198,64314
Baja California,50 a 54 años,2010,171104,86928,84176
Baja California,50 a 54 años,2020,221388,112789,108599
Baja California,5 a 9 años,1990,185303,94240,91063
Baja California,5 a 9 años,1995,238928,121542,117386
Baja California,5 a 9 años,2000,268682,136979,131703
Baja California,5 a 9 años,2005,267954,136245,131709
Baja California,5 a 9 años,2010,293234,149167,144067
Baja California,5 a 9 años,2020,299654,152609,147045
Baja California,45 a 49 años,1990,58601,29052,29549
Baja California,45 a 49 años,1995,80606,39883,40723
Baja California,45 a 49 años,2000,126564,63537,63027
Baja California,45 a 49 años,2005,164598,83803,80795
Baja California,45 a 49 años,2010,215049,110722,104327
Baja California,45 a 49 años,2020,260844,134187,126657
Baja California,40 a 44 años,1990,71766,35438,36328
Baja California,40 a 44 años,1995,105499,52968,52531
Baja California,40 a 44 años,2000,165348,83873,81475
Baja California,40 a 44 años,2005,208125,106746,101379
Baja California,40 a 44 años,2010,264063,135331,128732
Baja California,40 a 44 años,2020,273611,138332,135279
Baja California,35 a 39 años,1990,97317,48138,49179
Baja California,35 a 39 años,1995,143144,71708,71436
Baja California,35 a 39 años,2000,197807,100728,97079
Baja California,35 a 39 años,2005,240879,121987,118892
Baja California,35 a 39 años,2010,264023,132857,131166
Baja California,35 a 39 años,2020,292069,148169,143900
Baja California,30 a 34 años,1990,122683,60562,62121
Baja California,30 a 34 años,1995,175151,88797,86354
Baja California,30 a 34 años,2000,230907,116644,114263
Baja California,30 a 34 años,2005,241951,120390,121561
Baja California,30 a 34 años,2010,265428,133546,131882
Baja California,30 a 34 años,2020,302389,152164,150225
Baja California,25 a 29 años,1990,151366,75448,75918
Baja California,25 a 29 años,1995,208348,105757,102591
Baja California,25 a 29 años,2000,231966,115775,116191
Baja California,25 a 29 años,2005,246968,123808,123160
Baja California,25 a 29 años,2010,286479,144597,141882
Baja California,25 a 29 años,2020,328244,166250,161994
Baja California,20 a 24 años,1990,184182,92536,91646
Baja California,20 a 24 años,1995,240052,121008,119044
Baja California,20 a 24 años,2000,220707,112046,108661
Baja California,20 a 24 años,2005,255309,129298,126011
Baja California,20 a 24 años,2010,299195,152077,147118
Baja California,20 a 24 años,2020,340359,173450,166909
Baja California,15 a 19 años,1990,202116,102807,99309
Baja California,15 a 19 años,1995,215142,108162,106980
Baja California,15 a 19 años,2000,226758,115261,111497
Baja California,15 a 19 años,2005,267938,136669,131269
Baja California,15 a 19 años,2010,305472,155483,149989
Baja California,15 a 19 años,2020,315639,161298,154341
Baja California,100 años y más,1990,189,77,112
Baja California,100 años y más,1995,141,49,92
Baja California,100 años y más,2000,857,340,517
Baja California,100 años y más,2005,792,274,518
Baja California,100 años y más,2010,913,314,599
Baja California,100 años y más,2020,252,81,171
Baja California,10 a 14 años,1990,180428,90526,89902
Baja California,10 a 14 años,1995,208902,106410,102492
Baja California,10 a 14 años,2000,260331,132492,127839
Baja California,10 a 14 años,2005,277635,141538,136097
Baja California,10 a 14 años,2010,303180,153886,149294
Baja California,10 a 14 años,2020,312348,159306,153042
Baja California,0 a 4 años,1990,202831,102769,100062
Baja California,0 a 4 años,1995,257856,131186,126670
Baja California,0 a 4 años,2000,2487367,1252581,1234786
Baja California,0 a 4 años,2005,2844469,1431789,1412680
Baja California,0 a 4 años,2010,3155070,1591610,1563460
Baja California,0 a 4 años,2020,266301,134410,131891
Baja California Sur,No especificado,1990,3504,1783,1721
Baja California Sur,No especificado,1995,1119,591,528
Baja California Sur,No especificado,2000,53,23,30
Baja California Sur,No especificado,2005,45,18,27
Baja California Sur,No especificado,2010,58,27,31
Baja California Sur,No especificado,2020,3842,1913,1929
Baja California Sur,95 a 99 años,1990,97,33,64
Baja California Sur,95 a 99 años,1995,149,46,103
Baja California Sur,95 a 99 años,2000,361,161,200
Baja California Sur,95 a 99 años,2005,440,160,280
Baja California Sur,95 a 99 años,2010,655,265,390
Baja California Sur,95 a 99 años,2020,332,118,214
Baja California Sur,90 a 94 años,1990,250,102,148
Baja California Sur,90 a 94 años,1995,321,131,190
Baja California Sur,90 a 94 años,2000,966,408,558
Baja California Sur,90 a 94 años,2005,1168,483,685
Baja California Sur,90 a 94 años,2010,1589,677,912
Baja California Sur,90 a 94 años,2020,936,367,569
Baja California Sur,85 a 89 años,1990,698,299,399
Baja California Sur,85 a 89 años,1995,795,355,440
Baja California Sur,85 a 89 años,2000,1725,790,935
Baja California Sur,85 a 89 años,2005,2154,992,1162
Baja California Sur,85 a 89 años,2010,2805,1284,1521
Baja California Sur,85 a 89 años,2020,2556,1165,1391
Baja California Sur,80 a 84 años,1990,1129,518,611
Baja California Sur,80 a 84 años,1995,1430,657,773
Baja California Sur,80 a 84 años,2000,2894,1437,1457
Baja California Sur,80 a 84 años,2005,3488,1706,1782
Baja California Sur,80 a 84 años,2010,4598,2283,2315
Baja California Sur,80 a 84 años,2020,4649,2134,2515
Baja California Sur,75 a 79 años,1990,1896,921,975
Baja California Sur,75 a 79 años,1995,2353,1140,1213
Baja California Sur,75 a 79 años,2000,4176,2107,2069
Baja California Sur,75 a 79 años,2005,5254,2626,2628
Baja California Sur,75 a 79 años,2010,7012,3480,3532
Baja California Sur,75 a 79 años,2020,8166,3984,4182
Baja California Sur,70 a 74 años,1990,2709,1374,1335
Baja California Sur,70 a 74 años,1995,3560,1870,1690
Baja California Sur,70 a 74 años,2000,6145,3169,2976
Baja California Sur,70 a 74 años,2005,7544,3848,3696
Baja California Sur,70 a 74 años,2010,10279,5225,5054
Baja California Sur,70 a 74 años,2020,12545,6165,6380
Baja California Sur,65 a 69 años,1990,3954,2068,1886
Baja California Sur,65 a 69 años,1995,5061,2574,2487
Baja California Sur,65 a 69 años,2000,8248,4294,3954
Baja California Sur,65 a 69 años,2005,10783,5510,5273
Baja California Sur,65 a 69 años,2010,14895,7573,7322
Baja California Sur,65 a 69 años,2020,19274,9587,9687
Baja California Sur,60 a 64 años,1990,5301,2730,2571
Baja California Sur,60 a 64 años,1995,6868,3545,3323
Baja California Sur,60 a 64 años,2000,10631,5492,5139
Baja California Sur,60 a 64 años,2005,13781,7152,6629
Baja California Sur,60 a 64 años,2010,20188,10384,9804
Baja California Sur,60 a 64 años,2020,27095,13415,13680
Baja California Sur,55 a 59 años,1990,6897,3680,3217
Baja California Sur,55 a 59 años,1995,8618,4574,4044
Baja California Sur,55 a 59 años,2000,14109,7329,6780
Baja California Sur,55 a 59 años,2005,19430,10087,9343
Baja California Sur,55 a 59 años,2010,28122,14297,13825
Baja California Sur,55 a 59 años,2020,33731,16905,16826
Baja California Sur,50 a 54 años,1990,8654,4570,4084
Baja California Sur,50 a 54 años,1995,11611,6110,5501
Baja California Sur,50 a 54 años,2000,18593,9702,8891
Baja California Sur,50 a 54 años,2005,25121,12756,12365
Baja California Sur,50 a 54 años,2010,34308,17451,16857
Baja California Sur,50 a 54 años,2020,43337,21910,21427
Baja California Sur,5 a 9 años,1990,38661,19802,18859
Baja California Sur,5 a 9 años,1995,42977,21914,21063
Baja California Sur,5 a 9 años,2000,45613,23303,22310
Baja California Sur,5 a 9 años,2005,49069,25004,24065
Baja California Sur,5 a 9 años,2010,60758,30840,29918
Baja California Sur,5 a 9 años,2020,66933,33962,32971
Baja California Sur,45 a 49 años,1990,11427,6016,5411
Baja California Sur,45 a 49 años,1995,14905,7786,7119
Baja California Sur,45 a 49 años,2000,25053,12759,12294
Baja California Sur,45 a 49 años,2005,31526,15928,15598
Baja California Sur,45 a 49 años,2010,42163,21760,20403
Baja California Sur,45 a 49 años,2020,51771,26718,25053
Baja California Sur,40 a 44 años,1990,14151,7344,6807
Baja California Sur,40 a 44 años,1995,19764,10270,9494
Baja California Sur,40 a 44 años,2000,31282,15778,15504
Baja California Sur,40 a 44 años,2005,38197,19506,18691
Baja California Sur,40 a 44 años,2010,52235,26810,25425
Baja California Sur,40 a 44 años,2020,59389,30390,28999
Baja California Sur,35 a 39 años,1990,19309,10012,9297
Baja California Sur,35 a 39 años,1995,26784,13577,13207
Baja California Sur,35 a 39 años,2000,35609,18036,17573
Baja California Sur,35 a 39 años,2005,43628,22203,21425
Baja California Sur,35 a 39 años,2010,56159,28734,27425
Baja California Sur,35 a 39 años,2020,64927,33289,31638
Baja California Sur,30 a 34 años,1990,24249,12152,12097
Baja California Sur,30 a 34 años,1995,30976,15373,15603
Baja California Sur,30 a 34 años,2000,40264,20373,19891
Baja California Sur,30 a 34 años,2005,45939,23376,22563
Baja California Sur,30 a 34 años,2010,57525,29600,27925
Baja California Sur,30 a 34 años,2020,67779,34653,33126
Baja California Sur,25 a 29 años,1990,28300,14015,14285
Baja California Sur,25 a 29 años,1995,34454,17321,17133
Baja California Sur,25 a 29 años,2000,42278,21345,20933
Baja California Sur,25 a 29 años,2005,46222,23777,22445
Baja California Sur,25 a 29 años,2010,58690,30273,28417
Baja California Sur,25 a 29 años,2020,68798,35046,33752
Baja California Sur,20 a 24 años,1990,32187,16219,15968
Baja California Sur,20 a 24 años,1995,39231,19607,19624
Baja California Sur,20 a 24 años,2000,42376,21922,20454
Baja California Sur,20 a 24 años,2005,46700,24156,22544
Baja California Sur,20 a 24 años,2010,57713,29730,27983
Baja California Sur,20 a 24 años,2020,66743,34418,32325
Baja California Sur,15 a 19 años,1990,37202,19008,18194
Baja California Sur,15 a 19 años,1995,40586,20591,19995
Baja California Sur,15 a 19 años,2000,43302,22058,21244
Baja California Sur,15 a 19 años,2005,48106,24492,23614
Baja California Sur,15 a 19 años,2010,57380,29340,28040
Baja California Sur,15 a 19 años,2020,65469,33788,31681
Baja California Sur,100 años y más,1990,65,17,48
Baja California Sur,100 años y más,1995,35,13,22
Baja California Sur,100 años y más,2000,221,80,141
Baja California Sur,100 años y más,2005,177,76,101
Baja California Sur,100 años y más,2010,223,82,141
Baja California Sur,100 años y más,2020,55,18,37
Baja California Sur,10 a 14 años,1990,38849,19717,19132
Baja California Sur,10 a 14 años,1995,41165,21139,20026
Baja California Sur,10 a 14 años,2000,45929,23414,22515
Baja California Sur,10 a 14 años,2005,49164,25216,23948
Baja California Sur,10 a 14 años,2010,60334,30636,29698
Baja California Sur,10 a 14 años,2020,67665,34455,33210
Baja California Sur,0 a 4 años,1990,38275,19453,18822
Baja California Sur,0 a 4 años,1995,42732,21829,20903
Baja California Sur,0 a 4 años,2000,424041,216250,207791
Baja California Sur,0 a 4 años,2005,512170,261288,250882
Baja California Sur,0 a 4 años,2010,637026,325433,311593
Baja California Sur,0 a 4 años,2020,62455,31479,30976
Campeche,No especificado,1990,7603,3813,3790
Campeche,No especificado,1995,2029,1046,983
Campeche,No especificado,2000,149,79,70
Campeche,No especificado,2005,140,73,67
Campeche,No especificado,2010,142,75,67
Campeche,No especificado,2020,4294,2150,2144
Campeche,95 a 99 años,1990,236,123,113
Campeche,95 a 99 años,1995,304,162,142
Campeche,95 a 99 años,2000,714,370,344
Campeche,95 a 99 años,2005,890,451,439
Campeche,95 a 99 años,2010,1127,573,554
Campeche,95 a 99 años,2020,701,353,348
Campeche,90 a 94 años,1990,529,262,267
Campeche,90 a 94 años,1995,682,363,319
Campeche,90 a 94 años,2000,1777,912,865
Campeche,90 a 94 años,2005,2579,1333,1246
Campeche,90 a 94 años,2010,3209,1620,1589
Campeche,90 a 94 años,2020,1768,832,936
Campeche,85 a 89 años,1990,1193,621,572
Campeche,85 a 89 años,1995,1449,766,683
Campeche,85 a 89 años,2000,3421,1789,1632
Campeche,85 a 89 años,2005,4407,2250,2157
Campeche,85 a 89 años,2010,5254,2687,2567
Campeche,85 a 89 años,2020,4413,2113,2300
Campeche,80 a 84 años,1990,2260,1259,1001
Campeche,80 a 84 años,1995,2674,1408,1266
Campeche,80 a 84 años,2000,5787,3093,2694
Campeche,80 a 84 años,2005,7153,3780,3373
Campeche,80 a 84 años,2010,8320,4276,4044
Campeche,80 a 84 años,2020,7536,3718,3818
Campeche,75 a 79 años,1990,3362,1818,1544
Campeche,75 a 79 años,1995,4504,2443,2061
Campeche,75 a 79 años,2000,8374,4412,3962
Campeche,75 a 79 años,2005,9830,5097,4733
Campeche,75 a 79 años,2010,12890,6468,6422
Campeche,75 a 79 años,2020,11916,5984,5932
Campeche,70 a 74 años,1990,5448,2991,2457
Campeche,70 a 74 años,1995,7362,3982,3380
Campeche,70 a 74 años,2000,10683,5389,5294
Campeche,70 a 74 años,2005,12827,6339,6488
Campeche,70 a 74 años,2010,15079,7595,7484
Campeche,70 a 74 años,2020,17559,8668,8891
Campeche,65 a 69 años,1990,7175,3746,3429
Campeche,65 a 69 años,1995,9347,4867,4480
Campeche,65 a 69 años,2000,14546,7371,7175
Campeche,65 a 69 años,2005,17979,9081,8898
Campeche,65 a 69 años,2010,21379,10611,10768
Campeche,65 a 69 años,2020,25796,12530,13266
Campeche,60 a 64 años,1990,10404,5481,4923
Campeche,60 a 64 años,1995,12842,6619,6223
Campeche,60 a 64 años,2000,16699,8540,8159
Campeche,60 a 64 años,2005,21475,10823,10652
Campeche,60 a 64 años,2010,28316,14154,14162
Campeche,60 a 64 años,2020,32778,16020,16758
Campeche,55 a 59 años,1990,11782,6016,5766
Campeche,55 a 59 años,1995,14680,7439,7241
Campeche,55 a 59 años,2000,22362,11346,11016
Campeche,55 a 59 años,2005,29746,14818,14928
Campeche,55 a 59 años,2010,35658,17658,18000
Campeche,55 a 59 años,2020,40805,19857,20948
Campeche,50 a 54 años,1990,14480,7362,7118
Campeche,50 a 54 años,1995,18502,9543,8959
Campeche,50 a 54 años,2000,28962,14474,14488
Campeche,50 a 54 años,2005,36152,17881,18271
Campeche,50 a 54 años,2010,42811,21000,21811
Campeche,50 a 54 años,2020,50254,24392,25862
Campeche,5 a 9 años,1990,72228,36495,35733
Campeche,5 a 9 años,1995,80680,40787,39893
Campeche,5 a 9 años,2000,78424,39670,38754
Campeche,5 a 9 años,2005,73461,37327,36134
Campeche,5 a 9 años,2010,76925,39317,37608
Campeche,5 a 9 años,2020,82015,41624,40391
Campeche,45 a 49 años,1990,18748,9739,9009
Campeche,45 a 49 años,1995,24521,12510,12011
Campeche,45 a 49 años,2000,36088,18061,18027
Campeche,45 a 49 años,2005,43896,21696,22200
Campeche,45 a 49 años,2010,50522,24853,25669
Campeche,45 a 49 años,2020,57628,28036,29592
Campeche,40 a 44 años,1990,22303,11216,11087
Campeche,40 a 44 años,1995,30851,15718,15133
Campeche,40 a 44 años,2000,45603,22444,23159
Campeche,40 a 44 años,2005,52899,25770,27129
Campeche,40 a 44 años,2010,61896,30049,31847
Campeche,40 a 44 años,2020,64170,30761,33409
Campeche,35 a 39 años,1990,31017,15436,15581
Campeche,35 a 39 años,1995,40558,20102,20456
Campeche,35 a 39 años,2000,50021,24435,25586
Campeche,35 a 39 años,2005,59665,28481,31184
Campeche,35 a 39 años,2010,64927,30991,33936
Campeche,35 a 39 años,2020,70275,33611,36664
Campeche,30 a 34 años,1990,34489,17076,17413
Campeche,30 a 34 años,1995,45219,22241,22978
Campeche,30 a 34 años,2000,57599,27661,29938
Campeche,30 a 34 años,2005,62455,29579,32876
Campeche,30 a 34 años,2010,68197,32562,35635
Campeche,30 a 34 años,2020,72709,34557,38152
Campeche,25 a 29 años,1990,41646,20214,21432
Campeche,25 a 29 años,1995,52129,25406,26723
Campeche,25 a 29 años,2000,66395,31911,34484
Campeche,25 a 29 años,2005,70006,33347,36659
Campeche,25 a 29 años,2010,76388,37219,39169
Campeche,25 a 29 años,2020,72798,35046,37752
Campeche,20 a 24 años,1990,49953,24470,25483
Campeche,20 a 24 años,1995,64693,31663,33030
Campeche,20 a 24 años,2000,73769,36751,37018
Campeche,20 a 24 años,2005,77485,38458,39027
Campeche,20 a 24 años,2010,82920,41693,41227
Campeche,20 a 24 años,2020,75556,37277,38279
Campeche,15 a 19 años,1990,60846,30303,30543
Campeche,15 a 19 años,1995,71464,35725,35739
Campeche,15 a 19 años,2000,80246,40529,39717
Campeche,15 a 19 años,2005,83597,42346,41251
Campeche,15 a 19 años,2010,81314,41146,40168
Campeche,15 a 19 años,2020,76140,38468,37672
Campeche,100 años y más,1990,129,53,76
Campeche,100 años y más,1995,125,57,68
Campeche,100 años y más,2000,414,205,209
Campeche,100 años y más,2005,405,234,171
Campeche,100 años y más,2010,479,223,256
Campeche,100 años y más,2020,149,78,71
Campeche,10 a 14 años,1990,68224,34443,33781
Campeche,10 a 14 años,1995,77875,39434,38441
Campeche,10 a 14 años,2000,83090,41982,41108
Campeche,10 a 14 años,2005,79199,40040,39159
Campeche,10 a 14 años,2010,78299,39758,38541
Campeche,10 a 14 años,2020,80168,41047,39121
Campeche,0 a 4 años,1990,71130,35835,35295
Campeche,0 a 4 años,1995,80026,40710,39316
Campeche,0 a 4 años,2000,690689,344334,346355
Campeche,0 a 4 años,2005,754730,373457,381273
Campeche,0 a 4 años,2010,822441,407721,414720
Campeche,0 a 4 años,2020,78935,39817,39118
Chiapas,No especificado,1990,10865,5328,5537
Chiapas,No especificado,1995,17624,8719,8905
Chiapas,No especificado,2000,1241,611,630
Chiapas,No especificado,2005,1267,615,652
Chiapas,No especificado,2010,1467,726,741
Chiapas,No especificado,2020,27844,13901,13943
Chiapas,95 a 99 años,1990,1578,768,810
Chiapas,95 a 99 años,1995,1848,908,940
Chiapas,95 a 99 años,2000,3896,1892,2004
Chiapas,95 a 99 años,2005,4097,1993,2104
Chiapas,95 a 99 años,2010,5569,2754,2815
Chiapas,95 a 99 años,2020,3855,1752,2103
Chiapas,90 a 94 años,1990,3403,1708,1695
Chiapas,90 a 94 años,1995,3612,1833,1779
Chiapas,90 a 94 años,2000,7712,3817,3895
Chiapas,90 a 94 años,2005,10593,5355,5238
Chiapas,90 a 94 años,2010,13513,6572,6941
Chiapas,90 a 94 años,2020,8853,4300,4553
Chiapas,85 a 89 años,1990,5934,3101,2833
Chiapas,85 a 89 años,1995,6412,3299,3113
Chiapas,85 a 89 años,2000,14768,7451,7317
Chiapas,85 a 89 años,2005,19141,9728,9413
Chiapas,85 a 89 años,2010,24678,12299,12379
Chiapas,85 a 89 años,2020,21839,10638,11201
Chiapas,80 a 84 años,1990,12562,6253,6309
Chiapas,80 a 84 años,1995,13071,6495,6576
Chiapas,80 a 84 años,2000,23858,12422,11436
Chiapas,80 a 84 años,2005,31858,16440,15418
Chiapas,80 a 84 años,2010,39750,20238,19512
Chiapas,80 a 84 años,2020,38245,19047,19198
Chiapas,75 a 79 años,1990,15980,8480,7500
Chiapas,75 a 79 años,1995,18589,9796,8793
Chiapas,75 a 79 años,2000,37597,19429,18168
Chiapas,75 a 79 años,2005,46845,24124,22721
Chiapas,75 a 79 años,2010,68500,34470,34030
Chiapas,75 a 79 años,2020,63158,31971,31187
Chiapas,70 a 74 años,1990,26198,13593,12605
Chiapas,70 a 74 años,1995,31734,16544,15190
Chiapas,70 a 74 años,2000,49327,24592,24735
Chiapas,70 a 74 años,2005,63469,31538,31931
Chiapas,70 a 74 años,2010,78922,38302,40620
Chiapas,70 a 74 años,2020,85855,43119,42736
Chiapas,65 a 69 años,1990,31946,16456,15490
Chiapas,65 a 69 años,1995,40548,20533,20015
Chiapas,65 a 69 años,2000,72099,36805,35294
Chiapas,65 a 69 años,2005,98728,48847,49881
Chiapas,65 a 69 años,2010,110499,54902,55597
Chiapas,65 a 69 años,2020,125777,62035,63742
Chiapas,60 a 64 años,1990,52373,27349,25024
Chiapas,60 a 64 años,1995,61519,31695,29824
Chiapas,60 a 64 años,2000,83843,42296,41547
Chiapas,60 a 64 años,2005,103667,51992,51675
Chiapas,60 a 64 años,2010,137559,69026,68533
Chiapas,60 a 64 años,2020,158726,77668,81058
Chiapas,55 a 59 años,1990,59003,30533,28470
Chiapas,55 a 59 años,1995,71025,36280,34745
Chiapas,55 a 59 años,2000,110635,56191,54444
Chiapas,55 a 59 años,2005,139301,69845,69456
Chiapas,55 a 59 años,2010,174407,85517,88890
Chiapas,55 a 59 años,2020,196355,94905,101450
Chiapas,50 a 54 años,1990,80547,41531,39016
Chiapas,50 a 54 años,1995,96273,49650,46623
Chiapas,50 a 54 años,2000,141959,70479,71480
Chiapas,50 a 54 años,2005,176142,86422,89720
Chiapas,50 a 54 años,2010,212924,103387,109537
Chiapas,50 a 54 años,2020,243848,117157,126691
Chiapas,5 a 9 años,1990,492534,248484,244050
Chiapas,5 a 9 años,1995,509161,257540,251621
Chiapas,5 a 9 años,2000,483372,245014,238358
Chiapas,5 a 9 años,2005,490058,248713,241345
Chiapas,5 a 9 años,2010,540459,273660,266799
Chiapas,5 a 9 años,2020,612792,308758,304034
Chiapas,45 a 49 años,1990,106102,53861,52241
Chiapas,45 a 49 años,1995,124169,62898,61271
Chiapas,45 a 49 años,2000,174699,87135,87564
Chiapas,45 a 49 años,2005,210437,102657,107780
Chiapas,45 a 49 años,2010,246620,119049,127571
Chiapas,45 a 49 años,2020,284333,135809,148524
Chiapas,40 a 44 años,1990,122305,61690,60615
Chiapas,40 a 44 años,1995,151151,76939,74212
Chiapas,40 a 44 años,2000,226620,109185,117435
Chiapas,40 a 44 años,2005,257320,121598,135722
Chiapas,40 a 44 años,2010,307983,145306,162677
Chiapas,40 a 44 años,2020,329204,156472,172732
Chiapas,35 a 39 años,1990,172594,85577,87017
Chiapas,35 a 39 años,1995,207954,102135,105819
Chiapas,35 a 39 años,2000,242588,116714,125874
Chiapas,35 a 39 años,2005,283522,132962,150560
Chiapas,35 a 39 años,2010,335370,157234,178136
Chiapas,35 a 39 años,2020,372863,174270,198593
Chiapas,30 a 34 años,1990,189068,93918,95150
Chiapas,30 a 34 años,1995,222885,109684,113201
Chiapas,30 a 34 años,2000,292960,138292,154668
Chiapas,30 a 34 años,2005,324289,150453,173836
Chiapas,30 a 34 años,2010,366537,170660,195877
Chiapas,30 a 34 años,2020,396045,184761,211284
Chiapas,25 a 29 años,1990,242845,116953,125892
Chiapas,25 a 29 años,1995,273873,131357,142516
Chiapas,25 a 29 años,2000,361994,172044,189950
Chiapas,25 a 29 años,2005,383455,179238,204217
Chiapas,25 a 29 años,2010,438019,207582,230437
Chiapas,25 a 29 años,2020,424403,198455,225948
Chiapas,20 a 24 años,1990,290946,140236,150710
Chiapas,20 a 24 años,1995,339774,163857,175917
Chiapas,20 a 24 años,2000,433517,212353,221164
Chiapas,20 a 24 años,2005,471331,230408,240923
Chiapas,20 a 24 años,2010,530233,262407,267826
Chiapas,20 a 24 años,2020,464523,223732,240791
Chiapas,15 a 19 años,1990,364776,179226,185550
Chiapas,15 a 19 años,1995,417806,206179,211627
Chiapas,15 a 19 años,2000,488791,247331,241460
Chiapas,15 a 19 años,2005,537725,271971,265754
Chiapas,15 a 19 años,2010,549896,279274,270622
Chiapas,15 a 19 años,2020,526577,262521,264056
Chiapas,100 años y más,1990,1354,662,692
Chiapas,100 años y más,1995,1074,539,535
Chiapas,100 años y más,2000,2309,1126,1183
Chiapas,100 años y más,2005,2352,1175,1177
Chiapas,100 años y más,2010,2583,1226,1357
Chiapas,100 años y más,2020,1449,651,798
Chiapas,10 a 14 años,1990,438235,222491,215744
Chiapas,10 a 14 años,1995,473016,239795,233221
Chiapas,10 a 14 años,2000,518550,261521,257029
Chiapas,10 a 14 años,2005,512440,260077,252363
Chiapas,10 a 14 años,2010,554692,280057,274635
Chiapas,10 a 14 años,2020,583132,295114,288018
Chiapas,0 a 4 años,1990,489348,246575,242773
Chiapas,0 a 4 años,1995,501668,253905,247763
Chiapas,0 a 4 años,2000,3920892,1941880,1979012
Chiapas,0 a 4 años,2005,4293459,2108830,2184629
Chiapas,0 a 4 años,2010,4796580,2352807,2443773
Chiapas,0 a 4 años,2020,574152,288911,285241
Chihuahua,No especificado,1990,32158,15953,16205
Chihuahua,No especificado,1995,8612,4416,4196
Chihuahua,No especificado,2000,329,148,181
Chihuahua,No especificado,2005,224,90,134
Chihuahua,No especificado,2010,286,113,173
Chihuahua,No especificado,2020,7639,3813,3826
Chihuahua,95 a 99 años,1990,644,247,397
Chihuahua,95 a 99 años,1995,988,428,560
Chihuahua,95 a 99 años,2000,2770,1166,1604
Chihuahua,95 a 99 años,2005,2931,1158,1773
Chihuahua,95 a 99 años,2010,3294,1383,1911
Chihuahua,95 a 99 años,2020,1477,531,946
Chihuahua,90 a 94 años,1990,1969,849,1120
Chihuahua,90 a 94 años,1995,2387,1033,1354
Chihuahua,90 a 94 años,2000,7526,3344,4182
Chihuahua,90 a 94 años,2005,8045,3564,4481
Chihuahua,90 a 94 años,2010,10184,4404,5780
Chihuahua,90 a 94 años,2020,5376,2130,3246
Chihuahua,85 a 89 años,1990,5634,2508,3126
Chihuahua,85 a 89 años,1995,7069,3174,3895
Chihuahua,85 a 89 años,2000,12813,5889,6924
Chihuahua,85 a 89 años,2005,17235,7908,9327
Chihuahua,85 a 89 años,2010,20704,9435,11269
Chihuahua,85 a 89 años,2020,15250,6585,8665
Chihuahua,80 a 84 años,1990,11485,5410,6075
Chihuahua,80 a 84 años,1995,12527,5836,6691
Chihuahua,80 a 84 años,2000,24488,11965,12523
Chihuahua,80 a 84 años,2005,29983,14348,15635
Chihuahua,80 a 84 años,2010,34386,16544,17842
Chihuahua,80 a 84 años,2020,31387,14273,17114
Chihuahua,75 a 79 años,1990,18040,8752,9288
Chihuahua,75 a 79 años,1995,19503,9418,10085
Chihuahua,75 a 79 años,2000,37728,18255,19473
Chihuahua,75 a 79 años,2005,45078,21842,23236
Chihuahua,75 a 79 años,2010,54419,26273,28146
Chihuahua,75 a 79 años,2020,50265,23473,26792
Chihuahua,70 a 74 años,1990,24255,11765,12490
Chihuahua,70 a 74 años,1995,32628,16266,16362
Chihuahua,70 a 74 años,2000,51719,25177,26542
Chihuahua,70 a 74 años,2005,62659,30067,32592
Chihuahua,70 a 74 años,2010,68809,32811,35998
Chihuahua,70 a 74 años,2020,74018,34187,39831
Chihuahua,65 a 69 años,1990,36349,18043,18306
Chihuahua,65 a 69 años,1995,45828,22185,23643
Chihuahua,65 a 69 años,2000,71437,34821,36616
Chihuahua,65 a 69 años,2005,80050,38234,41816
Chihuahua,65 a 69 años,2010,89542,42534,47008
Chihuahua,65 a 69 años,2020,100944,47253,53691
Chihuahua,60 a 64 años,1990,51221,25053,26168
Chihuahua,60 a 64 años,1995,63150,31027,32123
Chihuahua,60 a 64 años,2000,81615,39566,42049
Chihuahua,60 a 64 años,2005,92987,44511,48476
Chihuahua,60 a 64 años,2010,108607,52311,56296
Chihuahua,60 a 64 años,2020,140861,66530,74331
Chihuahua,55 a 59 años,1990,60363,29981,30382
Chihuahua,55 a 59 años,1995,74656,36676,37980
Chihuahua,55 a 59 años,2000,103012,50052,52960
Chihuahua,55 a 59 años,2005,119550,57774,61776
Chihuahua,55 a 59 años,2010,149069,71988,77081
Chihuahua,55 a 59 años,2020,173639,84028,89611
Chihuahua,50 a 54 años,1990,79277,39300,39977
Chihuahua,50 a 54 años,1995,93325,45975,47350
Chihuahua,50 a 54 años,2000,121932,58943,62989
Chihuahua,50 a 54 años,2005,153968,74445,79523
Chihuahua,50 a 54 años,2010,183153,89363,93790
Chihuahua,50 a 54 años,2020,219930,107604,112326
Chihuahua,5 a 9 años,1990,285488,144750,140738
Chihuahua,5 a 9 años,1995,320170,162991,157179
Chihuahua,5 a 9 años,2000,334521,169900,164621
Chihuahua,5 a 9 años,2005,320384,162947,157437
Chihuahua,5 a 9 años,2010,322676,163607,159069
Chihuahua,5 a 9 años,2020,317322,161182,156140
Chihuahua,45 a 49 años,1990,94003,46202,47801
Chihuahua,45 a 49 años,1995,110031,53545,56486
Chihuahua,45 a 49 años,2000,162697,79276,83421
Chihuahua,45 a 49 años,2005,193322,94501,98821
Chihuahua,45 a 49 años,2010,222756,109944,112812
Chihuahua,45 a 49 años,2020,248522,123238,125284
Chihuahua,40 a 44 años,1990,106890,52131,54759
Chihuahua,40 a 44 años,1995,134678,66021,68657
Chihuahua,40 a 44 años,2000,207365,101506,105859
Chihuahua,40 a 44 años,2005,233533,114930,118603
Chihuahua,40 a 44 años,2010,259968,128448,131520
Chihuahua,40 a 44 años,2020,251983,124354,127629
Chihuahua,35 a 39 años,1990,134488,65467,69021
Chihuahua,35 a 39 años,1995,181098,88099,92999
Chihuahua,35 a 39 años,2000,242428,119203,123225
Chihuahua,35 a 39 años,2005,257676,127117,130559
Chihuahua,35 a 39 años,2010,251304,124137,127167
Chihuahua,35 a 39 años,2020,263669,130612,133057
Chihuahua,30 a 34 años,1990,167343,80883,86460
Chihuahua,30 a 34 años,1995,216249,106152,110097
Chihuahua,30 a 34 años,2000,272404,134363,138041
Chihuahua,30 a 34 años,2005,250016,123385,126631
Chihuahua,30 a 34 años,2010,255036,126385,128651
Chihuahua,30 a 34 años,2020,275644,135649,139995
Chihuahua,25 a 29 años,1990,205168,99585,105583
Chihuahua,25 a 29 años,1995,254432,125406,129026
Chihuahua,25 a 29 años,2000,280013,139615,140398
Chihuahua,25 a 29 años,2005,267506,133526,133980
Chihuahua,25 a 29 años,2010,285872,142953,142919
Chihuahua,25 a 29 años,2020,298299,147844,150455
Chihuahua,20 a 24 años,1990,254240,125338,128902
Chihuahua,20 a 24 años,1995,299966,148984,150982
Chihuahua,20 a 24 años,2000,290939,147754,143185
Chihuahua,20 a 24 años,2005,300186,151797,148389
Chihuahua,20 a 24 años,2010,322034,162488,159546
Chihuahua,20 a 24 años,2020,314067,157281,156786
Chihuahua,15 a 19 años,1990,299267,150558,148709
Chihuahua,15 a 19 años,1995,291853,146786,145067
Chihuahua,15 a 19 años,2000,306679,155835,150844
Chihuahua,15 a 19 años,2005,322642,163733,158909
Chihuahua,15 a 19 años,2010,324661,164749,159912
Chihuahua,15 a 19 años,2020,326333,165942,160391
Chihuahua,100 años y más,1990,318,121,197
Chihuahua,100 años y más,1995,218,90,128
Chihuahua,100 años y más,2000,1242,531,711
Chihuahua,100 años y más,2005,1078,400,678
Chihuahua,100 años y más,2010,1101,428,673
Chihuahua,100 años y más,2020,243,88,155
Chihuahua,10 a 14 años,1990,282115,142712,139403
Chihuahua,10 a 14 años,1995,293173,149003,144170
Chihuahua,10 a 14 años,2000,341921,173436,168485
Chihuahua,10 a 14 años,2005,324350,164698,159652
Chihuahua,10 a 14 años,2010,335064,170477,164587
Chihuahua,10 a 14 años,2020,333715,169615,164100
Chihuahua,0 a 4 años,1990,291158,147694,143464
Chihuahua,0 a 4 años,1995,330996,168403,162593
Chihuahua,0 a 4 años,2000,3052907,1519972,1532935
Chihuahua,0 a 4 años,2005,3241444,1610275,1631169
Chihuahua,0 a 4 años,2010,3406465,1692545,1713920
Chihuahua,0 a 4 años,2020,291286,147610,143676
Ciudad de México,No especificado,1990,28914,13421,15493
Ciudad de México,No especificado,1995,18650,8787,9863
Ciudad de México,No especificado,2000,1163,413,750
Ciudad de México,No especificado,2005,952,254,698
Ciudad de México,No especificado,2010,1089,321,768
Ciudad de México,No especificado,2020,9626,4783,4843
Ciudad de México,95 a 99 años,1990,3060,870,2190
Ciudad de México,95 a 99 años,1995,4126,1269,2857
Ciudad de México,95 a 99 años,2000,12237,3971,8266
Ciudad de México,95 a 99 años,2005,14084,4564,9520
Ciudad de México,95 a 99 años,2010,17225,5529,11696
Ciudad de México,95 a 99 años,2020,9066,2725,6341
Ciudad de México,90 a 94 años,1990,9038,2745,6293
Ciudad de México,90 a 94 años,1995,10508,3492,7016
Ciudad de México,90 a 94 años,2000,30845,10712,20133
Ciudad de México,90 a 94 años,2005,35912,12752,23160
Ciudad de México,90 a 94 años,2010,47170,17062,30108
Ciudad de México,90 a 94 años,2020,28780,9308,19472
Ciudad de México,85 a 89 años,1990,25300,8537,16763
Ciudad de México,85 a 89 años,1995,26414,9414,17000
Ciudad de México,85 a 89 años,2000,51638,19383,32255
Ciudad de México,85 a 89 años,2005,72725,27752,44973
Ciudad de México,85 a 89 años,2010,85121,32012,53109
Ciudad de México,85 a 89 años,2020,66316,24278,42038
Ciudad de México,80 a 84 años,1990,44999,16597,28402
Ciudad de México,80 a 84 años,1995,46687,17256,29431
Ciudad de México,80 a 84 años,2000,92943,38025,54918
Ciudad de México,80 a 84 años,2005,110512,44280,66232
Ciudad de México,80 a 84 años,2010,124499,50795,73704
Ciudad de México,80 a 84 años,2020,117480,46094,71386
Ciudad de México,75 a 79 años,1990,70158,27810,42348
Ciudad de México,75 a 79 años,1995,71291,29171,42120
Ciudad de México,75 a 79 años,2000,134345,55057,79288
Ciudad de México,75 a 79 años,2005,164150,67932,96218
Ciudad de México,75 a 79 años,2010,179329,75227,104102
Ciudad de México,75 a 79 años,2020,175215,74210,101005
Ciudad de México,70 a 74 años,1990,95658,39526,56132
Ciudad de México,70 a 74 años,1995,119920,50741,69179
Ciudad de México,70 a 74 años,2000,175174,73983,101191
Ciudad de México,70 a 74 años,2005,192699,83931,108768
Ciudad de México,70 a 74 años,2010,227625,99910,127715
Ciudad de México,70 a 74 años,2020,267744,115130,152614
Ciudad de México,65 a 69 años,1990,145729,62266,83463
Ciudad de México,65 a 69 años,1995,158713,66784,91929
Ciudad de México,65 a 69 años,2000,227283,99194,128089
Ciudad de México,65 a 69 años,2005,263228,117398,145830
Ciudad de México,65 a 69 años,2010,315793,141010,174783
Ciudad de México,65 a 69 años,2020,356196,157245,198951
Ciudad de México,60 a 64 años,1990,192053,82016,110037
Ciudad de México,60 a 64 años,1995,212782,92245,120537
Ciudad de México,60 a 64 años,2000,269845,122660,147185
Ciudad de México,60 a 64 años,2005,329553,150909,178644
Ciudad de México,60 a 64 años,2010,392186,179065,213121
Ciudad de México,60 a 64 años,2020,469514,209065,260449
Ciudad de México,55 a 59 años,1990,223519,99161,124358
Ciudad de México,55 a 59 años,1995,235829,106781,129048
Ciudad de México,55 a 59 años,2000,373595,171939,201656
Ciudad de México,55 a 59 años,2005,441077,202356,238721
Ciudad de México,55 a 59 años,2010,506310,230325,275985
Ciudad de México,55 a 59 años,2020,526447,239651,286796
Ciudad de México,50 a 54 años,1990,274523,124635,149888
Ciudad de México,50 a 54 años,1995,325253,151341,173912
Ciudad de México,50 a 54 años,2000,441804,203214,238590
Ciudad de México,50 a 54 años,2005,515878,237757,278121
Ciudad de México,50 a 54 años,2010,555481,256078,299403
Ciudad de México,50 a 54 años,2020,623483,286394,337089
Ciudad de México,5 a 9 años,1990,837642,423802,413840
Ciudad de México,5 a 9 años,1995,785466,399659,385807
Ciudad de México,5 a 9 años,2000,737934,375222,362712
Ciudad de México,5 a 9 años,2005,664092,338207,325885
Ciudad de México,5 a 9 años,2010,618245,314701,303544
Ciudad de México,5 a 9 años,2020,563907,286280,277627
Ciudad de México,45 a 49 años,1990,338444,158036,180408
Ciudad de México,45 a 49 años,1995,402093,188011,214082
Ciudad de México,45 a 49 años,2000,556565,258920,297645
Ciudad de México,45 a 49 años,2005,596540,278656,317884
Ciudad de México,45 a 49 años,2010,629563,295151,334412
Ciudad de México,45 a 49 años,2020,668945,313846,355099
Ciudad de México,40 a 44 años,1990,417720,196228,221492
Ciudad de México,40 a 44 años,1995,499935,236398,263537
Ciudad de México,40 a 44 años,2000,655973,307235,348738
Ciudad de México,40 a 44 años,2005,678990,319519,359471
Ciudad de México,40 a 44 años,2010,722214,341865,380349
Ciudad de México,40 a 44 años,2020,670307,317312,352995
Ciudad de México,35 a 39 años,1990,544706,255606,289100
Ciudad de México,35 a 39 años,1995,643428,303002,340426
Ciudad de México,35 a 39 años,2000,731452,346860,384592
Ciudad de México,35 a 39 años,2005,755600,359952,395648
Ciudad de México,35 a 39 años,2010,702642,335988,366654
Ciudad de México,35 a 39 años,2020,705850,340545,365305
Ciudad de México,30 a 34 años,1990,659098,310444,348654
Ciudad de México,30 a 34 años,1995,725263,343863,381400
Ciudad de México,30 a 34 años,2000,840487,403311,437176
Ciudad de México,30 a 34 años,2005,735441,353337,382104
Ciudad de México,30 a 34 años,2010,726696,352969,373727
Ciudad de México,30 a 34 años,2020,743611,363448,380163
Ciudad de México,25 a 29 años,1990,778695,372514,406181
Ciudad de México,25 a 29 años,1995,826960,398800,428160
Ciudad de México,25 a 29 años,2000,832517,400924,431593
Ciudad de México,25 a 29 años,2005,765641,373044,392597
Ciudad de México,25 a 29 años,2010,753404,372368,381036
Ciudad de México,25 a 29 años,2020,752289,372081,380208
Ciudad de México,20 a 24 años,1990,898114,430901,467213
Ciudad de México,20 a 24 años,1995,964075,464586,499489
Ciudad de México,20 a 24 años,2000,798349,390049,408300
Ciudad de México,20 a 24 años,2005,740280,368042,372238
Ciudad de México,20 a 24 años,2010,723372,363265,360107
Ciudad de México,20 a 24 años,2020,714605,359049,355556
Ciudad de México,15 a 19 años,1990,976029,472392,503637
Ciudad de México,15 a 19 años,1995,848416,412443,435973
Ciudad de México,15 a 19 años,2000,742986,375369,367617
Ciudad de México,15 a 19 años,2005,704950,357106,347844
Ciudad de México,15 a 19 años,2010,660345,334674,325671
Ciudad de México,15 a 19 años,2020,650389,331109,319280
Ciudad de México,100 años y más,1990,988,253,735
Ciudad de México,100 años y más,1995,685,186,499
Ciudad de México,100 años y más,2000,5012,1565,3447
Ciudad de México,100 años y más,2005,5176,1589,3587
Ciudad de México,100 años y más,2010,5797,1688,4109
Ciudad de México,100 años y más,2020,1308,357,951
Ciudad de México,10 a 14 años,1990,837766,418552,419214
Ciudad de México,10 a 14 años,1995,781808,394202,387606
Ciudad de México,10 a 14 años,2000,764094,387936,376158
Ciudad de México,10 a 14 años,2005,671579,341618,329961
Ciudad de México,10 a 14 años,2010,658948,334885,324063
Ciudad de México,10 a 14 años,2020,608962,309140,299822
Ciudad de México,0 a 4 años,1990,833591,423599,409992
Ciudad de México,0 a 4 años,1995,780705,397471,383234
Ciudad de México,0 a 4 años,2000,8605239,4110485,4494754
Ciudad de México,0 a 4 años,2005,8720916,4171683,4549233
Ciudad de México,0 a 4 años,2010,8851080,4233783,4617297
Ciudad de México,0 a 4 años,2020,479904,242877,237027
Coahuila de Zaragoza,No especificado,1990,11461,5655,5806
Coahuila de Zaragoza,No especificado,1995,3982,1937,2045
Coahuila de Zaragoza,No especificado,2000,253,87,166
Coahuila de Zaragoza,No especificado,2005,225,84,141
Coahuila de Zaragoza,No especificado,2010,263,91,172
Coahuila de Zaragoza,No especificado,2020,6159,3074,3085
Coahuila de Zaragoza,95 a 99 años,1990,633,238,395
Coahuila de Zaragoza,95 a 99 años,1995,873,370,503
Coahuila de Zaragoza,95 a 99 años,2000,2420,991,1429
Coahuila de Zaragoza,95 a 99 años,2005,2396,967,1429
Coahuila de Zaragoza,95 a 99 años,2010,2959,1238,1721
Coahuila de Zaragoza,95 a 99 años,2020,1408,529,879
Coahuila de Zaragoza,90 a 94 años,1990,1715,685,1030
Coahuila de Zaragoza,90 a 94 años,1995,2044,904,1140
Coahuila de Zaragoza,90 a 94 años,2000,6051,2555,3496
Coahuila de Zaragoza,90 a 94 años,2005,6882,3081,3801
Coahuila de Zaragoza,90 a 94 años,2010,9002,3900,5102
Coahuila de Zaragoza,90 a 94 años,2020,4712,1826,2886
Coahuila de Zaragoza,85 a 89 años,1990,5085,2353,2732
Coahuila de Zaragoza,85 a 89 años,1995,5983,2610,3373
Coahuila de Zaragoza,85 a 89 años,2000,10102,4679,5423
Coahuila de Zaragoza,85 a 89 años,2005,13768,6248,7520
Coahuila de Zaragoza,85 a 89 años,2010,17076,7645,9431
Coahuila de Zaragoza,85 a 89 años,2020,12495,5503,6992
Coahuila de Zaragoza,80 a 84 años,1990,9569,4361,5208
Coahuila de Zaragoza,80 a 84 años,1995,9618,4404,5214
Coahuila de Zaragoza,80 a 84 años,2000,19396,9322,10074
Coahuila de Zaragoza,80 a 84 años,2005,23529,11268,12261
Coahuila de Zaragoza,80 a 84 años,2010,27610,13197,14413
Coahuila de Zaragoza,80 a 84 años,2020,24851,11199,13652
Coahuila de Zaragoza,75 a 79 años,1990,14169,6750,7419
Coahuila de Zaragoza,75 a 79 años,1995,15572,7592,7980
Coahuila de Zaragoza,75 a 79 años,2000,28943,13890,15053
Coahuila de Zaragoza,75 a 79 años,2005,34186,16539,17647
Coahuila de Zaragoza,75 a 79 años,2010,42832,20407,22425
Coahuila de Zaragoza,75 a 79 años,2020,39801,18836,20965
Coahuila de Zaragoza,70 a 74 años,1990,19256,9409,9847
Coahuila de Zaragoza,70 a 74 años,1995,25443,12520,12923
Coahuila de Zaragoza,70 a 74 años,2000,39173,18870,20303
Coahuila de Zaragoza,70 a 74 años,2005,47679,22958,24721
Coahuila de Zaragoza,70 a 74 años,2010,55667,26827,28840
Coahuila de Zaragoza,70 a 74 años,2020,61684,29458,32226
Coahuila de Zaragoza,65 a 69 años,1990,29448,14444,15004
Coahuila de Zaragoza,65 a 69 años,1995,35309,16920,18389
Coahuila de Zaragoza,65 a 69 años,2000,53853,26017,27836
Coahuila de Zaragoza,65 a 69 años,2005,64043,30923,33120
Coahuila de Zaragoza,65 a 69 años,2010,77527,37467,40060
Coahuila de Zaragoza,65 a 69 años,2020,84422,40630,43792
Coahuila de Zaragoza,60 a 64 años,1990,40013,19422,20591
Coahuila de Zaragoza,60 a 64 años,1995,47416,23213,24203
Coahuila de Zaragoza,60 a 64 años,2000,63057,30959,32098
Coahuila de Zaragoza,60 a 64 años,2005,77889,38342,39547
Coahuila de Zaragoza,60 a 64 años,2010,95121,46924,48197
Coahuila de Zaragoza,60 a 64 años,2020,118950,57307,61643
Coahuila de Zaragoza,55 a 59 años,1990,47028,23310,23718
Coahuila de Zaragoza,55 a 59 años,1995,56802,28056,28746
Coahuila de Zaragoza,55 a 59 años,2000,82932,40702,42230
Coahuila de Zaragoza,55 a 59 años,2005,100907,49273,51634
Coahuila de Zaragoza,55 a 59 años,2010,125961,60909,65052
Coahuila de Zaragoza,55 a 59 años,2020,142215,69115,73100
Coahuila de Zaragoza,50 a 54 años,1990,61385,30195,31190
Coahuila de Zaragoza,50 a 54 años,1995,72230,35823,36407
Coahuila de Zaragoza,50 a 54 años,2000,98997,48525,50472
Coahuila de Zaragoza,50 a 54 años,2005,126257,61359,64898
Coahuila de Zaragoza,50 a 54 años,2010,150271,72906,77365
Coahuila de Zaragoza,50 a 54 años,2020,178214,86423,91791
Coahuila de Zaragoza,5 a 9 años,1990,235925,119677,116248
Coahuila de Zaragoza,5 a 9 años,1995,241326,122663,118663
Coahuila de Zaragoza,5 a 9 años,2000,253171,129130,124041
Coahuila de Zaragoza,5 a 9 años,2005,249590,126956,122634
Coahuila de Zaragoza,5 a 9 años,2010,258246,131289,126957
Coahuila de Zaragoza,5 a 9 años,2020,276224,140417,135807
Coahuila de Zaragoza,45 a 49 años,1990,74867,37181,37686
Coahuila de Zaragoza,45 a 49 años,1995,90101,44548,45553
Coahuila de Zaragoza,45 a 49 años,2000,128951,63095,65856
Coahuila de Zaragoza,45 a 49 años,2005,152496,74035,78461
Coahuila de Zaragoza,45 a 49 años,2010,177554,86374,91180
Coahuila de Zaragoza,45 a 49 años,2020,205202,100846,104356
Coahuila de Zaragoza,40 a 44 años,1990,88783,43667,45116
Coahuila de Zaragoza,40 a 44 años,1995,109439,54275,55164
Coahuila de Zaragoza,40 a 44 años,2000,157386,76375,81011
Coahuila de Zaragoza,40 a 44 años,2005,180228,87416,92812
Coahuila de Zaragoza,40 a 44 años,2010,211770,103371,108399
Coahuila de Zaragoza,40 a 44 años,2020,218687,106991,111696
Coahuila de Zaragoza,35 a 39 años,1990,112282,55433,56849
Coahuila de Zaragoza,35 a 39 años,1995,143230,69986,73244
Coahuila de Zaragoza,35 a 39 años,2000,179690,86903,92787
Coahuila de Zaragoza,35 a 39 años,2005,205193,99340,105853
Coahuila de Zaragoza,35 a 39 años,2010,216325,106088,110237
Coahuila de Zaragoza,35 a 39 años,2020,219634,109371,110263
Coahuila de Zaragoza,30 a 34 años,1990,136866,66375,70491
Coahuila de Zaragoza,30 a 34 años,1995,164412,79968,84444
Coahuila de Zaragoza,30 a 34 años,2000,204662,99588,105074
Coahuila de Zaragoza,30 a 34 años,2005,206859,101494,105365
Coahuila de Zaragoza,30 a 34 años,2010,210236,104230,106006
Coahuila de Zaragoza,30 a 34 años,2020,224329,110882,113447
Coahuila de Zaragoza,25 a 29 años,1990,160430,77799,82631
Coahuila de Zaragoza,25 a 29 años,1995,187979,91537,96442
Coahuila de Zaragoza,25 a 29 años,2000,223857,110790,113067
Coahuila de Zaragoza,25 a 29 años,2005,214562,107233,107329
Coahuila de Zaragoza,25 a 29 años,2010,230132,115443,114689
Coahuila de Zaragoza,25 a 29 años,2020,245917,122570,123347
Coahuila de Zaragoza,20 a 24 años,1990,198192,97253,100939
Coahuila de Zaragoza,20 a 24 años,1995,231564,113983,117581
Coahuila de Zaragoza,20 a 24 años,2000,225416,113776,111640
Coahuila de Zaragoza,20 a 24 años,2005,231405,116757,114648
Coahuila de Zaragoza,20 a 24 años,2010,261942,132477,129465
Coahuila de Zaragoza,20 a 24 años,2020,264313,133659,130654
Coahuila de Zaragoza,15 a 19 años,1990,243023,121309,121714
Coahuila de Zaragoza,15 a 19 años,1995,240739,120684,120055
Coahuila de Zaragoza,15 a 19 años,2000,234659,119135,115524
Coahuila de Zaragoza,15 a 19 años,2005,257591,130729,126862
Coahuila de Zaragoza,15 a 19 años,2010,268193,136153,132040
Coahuila de Zaragoza,15 a 19 años,2020,269284,136850,132434
Coahuila de Zaragoza,100 años y más,1990,277,109,168
Coahuila de Zaragoza,100 años y más,1995,169,66,103
Coahuila de Zaragoza,100 años y más,2000,1027,428,599
Coahuila de Zaragoza,100 años y más,2005,1056,393,663
Coahuila de Zaragoza,100 años y más,2010,1008,385,623
Coahuila de Zaragoza,100 años y más,2020,214,70,144
Coahuila de Zaragoza,10 a 14 años,1990,251883,126837,125046
Coahuila de Zaragoza,10 a 14 años,1995,236394,119915,116479
Coahuila de Zaragoza,10 a 14 años,2000,257228,130718,126510
Coahuila de Zaragoza,10 a 14 años,2005,257277,130816,126461
Coahuila de Zaragoza,10 a 14 años,2010,270736,137858,132878
Coahuila de Zaragoza,10 a 14 años,2020,268144,136301,131843
Coahuila de Zaragoza,0 a 4 años,1990,230050,116635,113415
Coahuila de Zaragoza,0 a 4 años,1995,253150,128620,124530
Coahuila de Zaragoza,0 a 4 años,2000,2298070,1140195,1157875
Coahuila de Zaragoza,0 a 4 años,2005,2495200,1236880,1258320
Coahuila de Zaragoza,0 a 4 años,2010,2748391,1364197,1384194
Coahuila de Zaragoza,0 a 4 años,2020,279912,141812,138100
Colima,No especificado,1990,4365,2163,2202
Colima,No especificado,1995,673,302,371
Colima,No especificado,2000,128,59,69
Colima,No especificado,2005,121,61,60
Colima,No especificado,2010,123,65,58
Colima,No especificado,2020,1956,975,981
Colima,95 a 99 años,1990,224,91,133
Colima,95 a 99 años,1995,335,138,197
Colima,95 a 99 años,2000,760,332,428
Colima,95 a 99 años,2005,946,435,511
Colima,95 a 99 años,2010,1259,531,728
Colima,95 a 99 años,2020,601,236,365
Colima,90 a 94 años,1990,528,248,280
Colima,90 a 94 años,1995,659,292,367
Colima,90 a 94 años,2000,1879,849,1030
Colima,90 a 94 años,2005,2327,1060,1267
Colima,90 a 94 años,2010,2906,1352,1554
Colima,90 a 94 años,2020,1571,655,916
Colima,85 a 89 años,1990,1246,580,666
Colima,85 a 89 años,1995,1551,740,811
Colima,85 a 89 años,2000,3129,1474,1655
Colima,85 a 89 años,2005,3908,1821,2087
Colima,85 a 89 años,2010,4565,2050,2515
Colima,85 a 89 años,2020,3623,1561,2062
Colima,80 a 84 años,1990,2222,1087,1135
Colima,80 a 84 años,1995,2778,1289,1489
Colima,80 a 84 años,2000,5086,2532,2554
Colima,80 a 84 años,2005,5679,2765,2914
Colima,80 a 84 años,2010,6976,3375,3601
Colima,80 a 84 años,2020,6859,3103,3756
Colima,75 a 79 años,1990,3497,1702,1795
Colima,75 a 79 años,1995,4261,2092,2169
Colima,75 a 79 años,2000,6599,3297,3302
Colima,75 a 79 años,2005,7947,3836,4111
Colima,75 a 79 años,2010,10239,4918,5321
Colima,75 a 79 años,2020,10803,5101,5702
Colima,70 a 74 años,1990,5054,2509,2545
Colima,70 a 74 años,1995,6251,3167,3084
Colima,70 a 74 años,2000,8777,4211,4566
Colima,70 a 74 años,2005,10530,5110,5420
Colima,70 a 74 años,2010,13806,6765,7041
Colima,70 a 74 años,2020,16086,7710,8376
Colima,65 a 69 años,1990,6631,3271,3360
Colima,65 a 69 años,1995,7519,3722,3797
Colima,65 a 69 años,2000,11339,5529,5810
Colima,65 a 69 años,2005,14442,7075,7367
Colima,65 a 69 años,2010,18355,8939,9416
Colima,65 a 69 años,2020,22071,10602,11469
Colima,60 a 64 años,1990,8057,3994,4063
Colima,60 a 64 años,1995,9813,4778,5035
Colima,60 a 64 años,2000,14053,7006,7047
Colima,60 a 64 años,2005,17614,8732,8882
Colima,60 a 64 años,2010,23301,11581,11720
Colima,60 a 64 años,2020,29795,14473,15322
Colima,55 a 59 años,1990,9293,4640,4653
Colima,55 a 59 años,1995,11815,5949,5866
Colima,55 a 59 años,2000,18269,9096,9173
Colima,55 a 59 años,2005,23348,11439,11909
Colima,55 a 59 años,2010,30917,15247,15670
Colima,55 a 59 años,2020,34819,16843,17976
Colima,50 a 54 años,1990,12009,5960,6049
Colima,50 a 54 años,1995,15550,7739,7811
Colima,50 a 54 años,2000,22683,11218,11465
Colima,50 a 54 años,2005,28969,14171,14798
Colima,50 a 54 años,2010,35812,17505,18307
Colima,50 a 54 años,2020,41541,20037,21504
Colima,5 a 9 años,1990,54412,27572,26840
Colima,5 a 9 años,1995,57304,29014,28290
Colima,5 a 9 años,2000,53295,27427,25868
Colima,5 a 9 años,2005,51929,26388,25541
Colima,5 a 9 años,2010,58263,29676,28587
Colima,5 a 9 años,2020,60049,30646,29403
Colima,45 a 49 años,1990,15453,7749,7704
Colima,45 a 49 años,1995,19427,9797,9630
Colima,45 a 49 años,2000,29529,14500,15029
Colima,45 a 49 años,2005,34968,16970,17998
Colima,45 a 49 años,2010,41432,20101,21331
Colima,45 a 49 años,2020,47133,23147,23986
Colima,40 a 44 años,1990,18372,9133,9239
Colima,40 a 44 años,1995,24674,12314,12360
Colima,40 a 44 años,2000,35524,17173,18351
Colima,40 a 44 años,2005,39605,18850,20755
Colima,40 a 44 años,2010,48863,23868,24995
Colima,40 a 44 años,2020,51179,24786,26393
Colima,35 a 39 años,1990,24122,11835,12287
Colima,35 a 39 años,1995,32099,15693,16406
Colima,35 a 39 años,2000,38024,17968,20056
Colima,35 a 39 años,2005,44016,21077,22939
Colima,35 a 39 años,2010,50521,24590,25931
Colima,35 a 39 años,2020,54566,26634,27932
Colima,30 a 34 años,1990,28739,13998,14741
Colima,30 a 34 años,1995,35694,17201,18493
Colima,30 a 34 años,2000,43310,20598,22712
Colima,30 a 34 años,2005,44660,21164,23496
Colima,30 a 34 años,2010,53136,25994,27142
Colima,30 a 34 años,2020,57436,27688,29748
Colima,25 a 29 años,1990,33413,16014,17399
Colima,25 a 29 años,1995,39747,18987,20760
Colima,25 a 29 años,2000,48878,23281,25597
Colima,25 a 29 años,2005,50049,24135,25914
Colima,25 a 29 años,2010,60070,29487,30583
Colima,25 a 29 años,2020,58035,28584,29451
Colima,20 a 24 años,1990,40023,19064,20959
Colima,20 a 24 años,1995,50183,24385,25798
Colima,20 a 24 años,2000,54826,27289,27537
Colima,20 a 24 años,2005,56534,28076,28458
Colima,20 a 24 años,2010,62323,31543,30780
Colima,20 a 24 años,2020,59343,29637,29706
Colima,15 a 19 años,1990,52837,26276,26561
Colima,15 a 19 años,1995,55665,27879,27786
Colima,15 a 19 años,2000,57422,29057,28365
Colima,15 a 19 años,2005,56990,29280,27710
Colima,15 a 19 años,2010,59473,30707,28766
Colima,15 a 19 años,2020,60663,30667,29996
Colima,100 años y más,1990,135,43,92
Colima,100 años y más,1995,74,34,40
Colima,100 años y más,2000,397,180,217
Colima,100 años y más,2005,416,183,233
Colima,100 años y más,2010,499,228,271
Colima,100 años y más,2020,148,53,95
Colima,10 a 14 años,1990,55609,28241,27368
Colima,10 a 14 años,1995,57444,29269,28175
Colima,10 a 14 años,2000,57165,29298,27867
Colima,10 a 14 años,2005,53742,27734,26008
Colima,10 a 14 años,2010,59869,30334,29535
Colima,10 a 14 años,2020,60801,30952,29849
Colima,0 a 4 años,1990,52269,26373,25896
Colima,0 a 4 años,1995,54512,28006,26506
Colima,0 a 4 años,2000,542627,268192,274435
Colima,0 a 4 años,2005,567996,280005,287991
Colima,0 a 4 años,2010,650555,322790,327765
Colima,0 a 4 años,2020,52313,26532,25781
Durango,No especificado,1990,2797,1369,1428
Durango,No especificado,1995,3225,1613,1612
Durango,No especificado,2000,255,104,151
Durango,No especificado,2005,243,104,139
Durango,No especificado,2010,235,84,151
Durango,No especificado,2020,3175,1576,1599
Durango,95 a 99 años,1990,553,241,312
Durango,95 a 99 años,1995,692,303,389
Durango,95 a 99 años,2000,1906,856,1050
Durango,95 a 99 años,2005,1784,813,971
Durango,95 a 99 años,2010,1953,843,1110
Durango,95 a 99 años,2020,1012,418,594
Durango,90 a 94 años,1990,1468,676,792
Durango,90 a 94 años,1995,1612,762,850
Durango,90 a 94 años,2000,4431,2068,2363
Durango,90 a 94 años,2005,4700,2165,2535
Durango,90 a 94 años,2010,6079,2885,3194
Durango,90 a 94 años,2020,3333,1441,1892
Durango,85 a 89 años,1990,3908,1899,2009
Durango,85 a 89 años,1995,4640,2213,2427
Durango,85 a 89 años,2000,6877,3247,3630
Durango,85 a 89 años,2005,9837,4828,5009
Durango,85 a 89 años,2010,12039,5751,6288
Durango,85 a 89 años,2020,9042,4191,4851
Durango,80 a 84 años,1990,7515,3696,3819
Durango,80 a 84 años,1995,7168,3453,3715
Durango,80 a 84 años,2000,13433,6802,6631
Durango,80 a 84 años,2005,16824,8396,8428
Durango,80 a 84 años,2010,19595,9739,9856
Durango,80 a 84 años,2020,17026,8058,8968
Durango,75 a 79 años,1990,10397,5211,5186
Durango,75 a 79 años,1995,10563,5306,5257
Durango,75 a 79 años,2000,20362,10158,10204
Durango,75 a 79 años,2005,24425,12125,12300
Durango,75 a 79 años,2010,29733,14618,15115
Durango,75 a 79 años,2020,25689,12593,13096
Durango,70 a 74 años,1990,13507,6714,6793
Durango,70 a 74 años,1995,17811,9022,8789
Durango,70 a 74 años,2000,27761,13685,14076
Durango,70 a 74 años,2005,31835,15693,16142
Durango,70 a 74 años,2010,34601,16948,17653
Durango,70 a 74 años,2020,36956,17758,19198
Durango,65 a 69 años,1990,20214,10259,9955
Durango,65 a 69 años,1995,24605,12220,12385
Durango,65 a 69 años,2000,36689,17978,18711
Durango,65 a 69 años,2005,40026,19550,20476
Durango,65 a 69 años,2010,44693,21418,23275
Durango,65 a 69 años,2020,49727,23758,25969
Durango,60 a 64 años,1990,28239,14006,14233
Durango,60 a 64 años,1995,33863,16789,17074
Durango,60 a 64 años,2000,39206,19190,20016
Durango,60 a 64 años,2005,45386,21832,23554
Durango,60 a 64 años,2010,53875,26022,27853
Durango,60 a 64 años,2020,66536,31635,34901
Durango,55 a 59 años,1990,33821,16765,17056
Durango,55 a 59 años,1995,37306,18511,18795
Durango,55 a 59 años,2000,48972,23698,25274
Durango,55 a 59 años,2005,57570,27707,29863
Durango,55 a 59 años,2010,70274,33322,36952
Durango,55 a 59 años,2020,79997,37971,42026
Durango,50 a 54 años,1990,41529,20480,21049
Durango,50 a 54 años,1995,45710,22699,23011
Durango,50 a 54 años,2000,57469,27538,29931
Durango,50 a 54 años,2005,70558,33419,37139
Durango,50 a 54 años,2010,82516,38967,43549
Durango,50 a 54 años,2020,97009,45980,51029
Durango,5 a 9 años,1990,182860,92794,90066
Durango,5 a 9 años,1995,180229,91542,88687
Durango,5 a 9 años,2000,168897,85927,82970
Durango,5 a 9 años,2005,158588,80812,77776
Durango,5 a 9 años,2010,161700,82046,79654
Durango,5 a 9 años,2020,176033,89816,86217
Durango,45 a 49 años,1990,48644,23760,24884
Durango,45 a 49 años,1995,54268,26415,27853
Durango,45 a 49 años,2000,73203,34716,38487
Durango,45 a 49 años,2005,85571,40303,45268
Durango,45 a 49 años,2010,96859,46107,50752
Durango,45 a 49 años,2020,108070,52309,55761
Durango,40 a 44 años,1990,54334,26212,28122
Durango,40 a 44 años,1995,64382,31247,33135
Durango,40 a 44 años,2000,90218,42492,47726
Durango,40 a 44 años,2005,99365,46784,52581
Durango,40 a 44 años,2010,112837,54244,58593
Durango,40 a 44 años,2020,114976,55778,59198
Durango,35 a 39 años,1990,68315,32720,35595
Durango,35 a 39 años,1995,83865,40309,43556
Durango,35 a 39 años,2000,100022,46641,53381
Durango,35 a 39 años,2005,110058,51803,58255
Durango,35 a 39 años,2010,115294,55171,60123
Durango,35 a 39 años,2020,118830,57634,61196
Durango,30 a 34 años,1990,80561,38066,42495
Durango,30 a 34 años,1995,95654,45515,50139
Durango,30 a 34 años,2000,113003,53011,59992
Durango,30 a 34 años,2005,111556,52329,59227
Durango,30 a 34 años,2010,117714,56978,60736
Durango,30 a 34 años,2020,129526,63232,66294
Durango,25 a 29 años,1990,96432,45069,51363
Durango,25 a 29 años,1995,109163,51815,57348
Durango,25 a 29 años,2000,129322,61380,67942
Durango,25 a 29 años,2005,124920,59372,65548
Durango,25 a 29 años,2010,143377,70380,72997
Durango,25 a 29 años,2020,141107,69038,72069
Durango,20 a 24 años,1990,121376,57112,64264
Durango,20 a 24 años,1995,140244,68068,72176
Durango,20 a 24 años,2000,150569,74630,75939
Durango,20 a 24 años,2005,156434,77795,78639
Durango,20 a 24 años,2010,166366,84036,82330
Durango,20 a 24 años,2020,153588,76936,76652
Durango,15 a 19 años,1990,165463,82090,83373
Durango,15 a 19 años,1995,165403,83030,82373
Durango,15 a 19 años,2000,172365,87255,85110
Durango,15 a 19 años,2005,171314,86908,84406
Durango,15 a 19 años,2010,167180,84969,82211
Durango,15 a 19 años,2020,162990,82839,80151
Durango,100 años y más,1990,208,74,134
Durango,100 años y más,1995,189,59,130
Durango,100 años y más,2000,886,383,503
Durango,100 años y más,2005,798,346,452
Durango,100 años y más,2010,753,336,417
Durango,100 años y más,2020,157,60,97
Durango,10 a 14 años,1990,189988,96000,93988
Durango,10 a 14 años,1995,175910,89312,86598
Durango,10 a 14 años,2000,177062,89736,87326
Durango,10 a 14 años,2005,165488,84071,81417
Durango,10 a 14 años,2010,166853,84823,82030
Durango,10 a 14 años,2020,170271,86764,83507
Durango,0 a 4 años,1990,177249,89553,87696
Durango,0 a 4 años,1995,175246,89065,86181
Durango,0 a 4 años,2000,1448661,709521,739140
Durango,0 a 4 años,2005,1509117,738095,771022
Durango,0 a 4 años,2010,1632934,803890,829044
Durango,0 a 4 años,2020,167600,85081,82519
Estados Unidos Mexicanos,No especificado,2000,19757,8029,11728
Estados Unidos Mexicanos,95 a 99 años,2000,122006,50843,71163
Estados Unidos Mexicanos,90 a 94 años,2000,290051,125041,165010
Estados Unidos Mexicanos,85 a 89 años,2000,483876,217330,266546
Estados Unidos Mexicanos,80 a 84 años,2000,865270,411197,454073
Estados Unidos Mexicanos,75 a 79 años,2000,1245674,589106,656568
Estados Unidos Mexicanos,70 a 74 años,2000,1660785,779666,881119
Estados Unidos Mexicanos,65 a 69 años,2000,2198146,1045404,1152742
Estados Unidos Mexicanos,60 a 64 años,2000,2559231,1234072,1325159
Estados Unidos Mexicanos,55 a 59 años,2000,3357953,1624033,1733920
Estados Unidos Mexicanos,50 a 54 años,2000,4072091,1957177,2114914
Estados Unidos Mexicanos,5 a 9 años,2000,10635157,5401306,5233851
Estados Unidos Mexicanos,45 a 49 años,2000,5194833,2494771,2700062
Estados Unidos Mexicanos,40 a 44 años,2000,6352538,3023328,3329210
Estados Unidos Mexicanos,35 a 39 años,2000,7136523,3383356,3753167
Estados Unidos Mexicanos,30 a 34 años,2000,8157743,3861482,4296261
Estados Unidos Mexicanos,25 a 29 años,2000,9071134,4303600,4767534
Estados Unidos Mexicanos,20 a 24 años,2000,9992135,4909648,5082487
Estados Unidos Mexicanos,15 a 19 años,2000,10736493,5435737,5300756
Estados Unidos Mexicanos,100 años y más,2000,62892,25741,37151
Estados Unidos Mexicanos,10 a 14 años,2000,11215323,5677711,5537612
Estados Unidos Mexicanos,0 a 4 años,2000,97483412,47592253,49891159
Guanajuato,No especificado,1990,43512,20927,22585
Guanajuato,No especificado,1995,7470,3447,4023
Guanajuato,No especificado,2000,878,341,537
Guanajuato,No especificado,2005,754,269,485
Guanajuato,No especificado,2010,766,276,490
Guanajuato,No especificado,2020,12049,6006,6043
Guanajuato,95 a 99 años,1990,2066,809,1257
Guanajuato,95 a 99 años,1995,2681,1132,1549
Guanajuato,95 a 99 años,2000,7235,3143,4092
Guanajuato,95 a 99 años,2005,7351,3125,4226
Guanajuato,95 a 99 años,2010,8603,3616,4987
Guanajuato,95 a 99 años,2020,5009,1992,3017
Guanajuato,90 a 94 años,1990,5367,2349,3018
Guanajuato,90 a 94 años,1995,6241,2787,3454
Guanajuato,90 a 94 años,2000,15706,7049,8657
Guanajuato,90 a 94 años,2005,17077,7610,9467
Guanajuato,90 a 94 años,2010,24163,10738,13425
Guanajuato,90 a 94 años,2020,14003,5815,8188
Guanajuato,85 a 89 años,1990,13548,6292,7256
Guanajuato,85 a 89 años,1995,14196,6651,7545
Guanajuato,85 a 89 años,2000,23925,10852,13073
Guanajuato,85 a 89 años,2005,34405,15638,18767
Guanajuato,85 a 89 años,2010,42362,19159,23203
Guanajuato,85 a 89 años,2020,31747,14089,17658
Guanajuato,80 a 84 años,1990,23359,10828,12531
Guanajuato,80 a 84 años,1995,23999,10900,13099
Guanajuato,80 a 84 años,2000,42290,20215,22075
Guanajuato,80 a 84 años,2005,51797,24481,27316
Guanajuato,80 a 84 años,2010,60341,28292,32049
Guanajuato,80 a 84 años,2020,54366,24455,29911
Guanajuato,75 a 79 años,1990,30476,14465,16011
Guanajuato,75 a 79 años,1995,31365,14860,16505
Guanajuato,75 a 79 años,2000,62089,29690,32399
Guanajuato,75 a 79 años,2005,71388,33672,37716
Guanajuato,75 a 79 años,2010,86650,40438,46212
Guanajuato,75 a 79 años,2020,81110,38242,42868
Guanajuato,70 a 74 años,1990,40520,19316,21204
Guanajuato,70 a 74 años,1995,53790,26018,27772
Guanajuato,70 a 74 años,2000,76586,36029,40557
Guanajuato,70 a 74 años,2005,87450,41027,46423
Guanajuato,70 a 74 años,2010,105229,49694,55535
Guanajuato,70 a 74 años,2020,118285,55393,62892
Guanajuato,65 a 69 años,1990,55479,26561,28918
Guanajuato,65 a 69 años,1995,67006,31703,35303
Guanajuato,65 a 69 años,2000,98676,46357,52319
Guanajuato,65 a 69 años,2005,117552,54792,62760
Guanajuato,65 a 69 años,2010,140229,65751,74478
Guanajuato,65 a 69 años,2020,161765,75898,85867
Guanajuato,60 a 64 años,1990,77502,36783,40719
Guanajuato,60 a 64 años,1995,90404,42947,47457
Guanajuato,60 a 64 años,2000,111802,53119,58683
Guanajuato,60 a 64 años,2005,135455,64147,71308
Guanajuato,60 a 64 años,2010,174400,82431,91969
Guanajuato,60 a 64 años,2020,214406,99483,114923
Guanajuato,55 a 59 años,1990,85656,40946,44710
Guanajuato,55 a 59 años,1995,96922,46387,50535
Guanajuato,55 a 59 años,2000,146282,69721,76561
Guanajuato,55 a 59 años,2005,180011,84056,95955
Guanajuato,55 a 59 años,2010,225760,105052,120708
Guanajuato,55 a 59 años,2020,250808,116934,133874
Guanajuato,50 a 54 años,1990,106186,50466,55720
Guanajuato,50 a 54 años,1995,127784,61421,66363
Guanajuato,50 a 54 años,2000,177786,84189,93597
Guanajuato,50 a 54 años,2005,219520,102288,117232
Guanajuato,50 a 54 años,2010,266465,123887,142578
Guanajuato,50 a 54 años,2020,318197,148310,169887
Guanajuato,5 a 9 años,1990,552143,278071,274072
Guanajuato,5 a 9 años,1995,561618,284373,277245
Guanajuato,5 a 9 años,2000,564593,286535,278058
Guanajuato,5 a 9 años,2005,527480,267399,260081
Guanajuato,5 a 9 años,2010,547466,277260,270206
Guanajuato,5 a 9 años,2020,547545,277429,270116
Guanajuato,45 a 49 años,1990,129632,61931,67701
Guanajuato,45 a 49 años,1995,157073,75860,81213
Guanajuato,45 a 49 años,2000,229441,107801,121640
Guanajuato,45 a 49 años,2005,269592,124556,145036
Guanajuato,45 a 49 años,2010,324654,150828,173826
Guanajuato,45 a 49 años,2020,365660,174419,191241
Guanajuato,40 a 44 años,1990,153691,73562,80129
Guanajuato,40 a 44 años,1995,196209,94705,101504
Guanajuato,40 a 44 años,2000,280637,129610,151027
Guanajuato,40 a 44 años,2005,321689,147170,174519
Guanajuato,40 a 44 años,2010,387687,181162,206525
Guanajuato,40 a 44 años,2020,407230,192549,214681
Guanajuato,35 a 39 años,1990,201188,95220,105968
Guanajuato,35 a 39 años,1995,255552,121364,134188
Guanajuato,35 a 39 años,2000,322249,147304,174945
Guanajuato,35 a 39 años,2005,361384,163437,197947
Guanajuato,35 a 39 años,2010,407712,187888,219824
Guanajuato,35 a 39 años,2020,439045,208278,230767
Guanajuato,30 a 34 años,1990,238296,111057,127239
Guanajuato,30 a 34 años,1995,292316,136510,155806
Guanajuato,30 a 34 años,2000,371568,167169,204399
Guanajuato,30 a 34 años,2005,377109,167451,209658
Guanajuato,30 a 34 años,2010,425291,196248,229043
Guanajuato,30 a 34 años,2020,462332,218363,243969
Guanajuato,25 a 29 años,1990,285440,130966,154474
Guanajuato,25 a 29 años,1995,345170,159824,185346
Guanajuato,25 a 29 años,2000,435713,195148,240565
Guanajuato,25 a 29 años,2005,425409,188993,236416
Guanajuato,25 a 29 años,2010,493167,230992,262175
Guanajuato,25 a 29 años,2020,501868,242026,259842
Guanajuato,20 a 24 años,1990,367907,166925,200982
Guanajuato,20 a 24 años,1995,443945,204358,239587
Guanajuato,20 a 24 años,2000,501053,238000,263053
Guanajuato,20 a 24 años,2005,504643,241953,262690
Guanajuato,20 a 24 años,2010,570965,281501,289464
Guanajuato,20 a 24 años,2020,540587,267148,273439
Guanajuato,15 a 19 años,1990,479117,229949,249168
Guanajuato,15 a 19 años,1995,513332,248784,264548
Guanajuato,15 a 19 años,2000,560147,282245,277902
Guanajuato,15 a 19 años,2005,569357,286789,282568
Guanajuato,15 a 19 años,2010,580600,293612,286988
Guanajuato,15 a 19 años,2020,552092,277977,274115
Guanajuato,100 años y más,1990,873,280,593
Guanajuato,100 años y más,1995,551,174,377
Guanajuato,100 años y más,2000,3680,1528,2152
Guanajuato,100 años y más,2005,3392,1396,1996
Guanajuato,100 años y más,2010,3588,1403,2185
Guanajuato,100 años y más,2020,683,227,456
Guanajuato,10 a 14 años,1990,547837,274980,272857
Guanajuato,10 a 14 años,1995,557242,280314,276928
Guanajuato,10 a 14 años,2000,582207,293238,288969
Guanajuato,10 a 14 años,2005,551459,279081,272378
Guanajuato,10 a 14 años,2010,579121,293697,285424
Guanajuato,10 a 14 años,2020,549301,278676,270625
Guanajuato,0 a 4 años,1990,542798,274052,268746
Guanajuato,0 a 4 años,1995,561702,284585,277117
Guanajuato,0 a 4 años,2000,4663032,2233315,2429717
Guanajuato,0 a 4 años,2005,4893812,2329136,2564676
Guanajuato,0 a 4 años,2010,5486372,2639425,2846947
Guanajuato,0 a 4 años,2020,538846,272745,266101
Guerrero,No especificado,1990,31081,15145,15936
Guerrero,No especificado,1995,12233,5294,6939
Guerrero,No especificado,2000,1224,538,686
Guerrero,No especificado,2005,1126,486,640
Guerrero,No especificado,2010,1186,505,681
Guerrero,No especificado,2020,14417,7196,7221
Guerrero,95 a 99 años,1990,1556,683,873
Guerrero,95 a 99 años,1995,2028,911,1117
Guerrero,95 a 99 años,2000,4558,2034,2524
Guerrero,95 a 99 años,2005,4612,2040,2572
Guerrero,95 a 99 años,2010,5898,2667,3231
Guerrero,95 a 99 años,2020,3950,1657,2293
Guerrero,90 a 94 años,1990,3731,1693,2038
Guerrero,90 a 94 años,1995,3822,1675,2147
Guerrero,90 a 94 años,2000,9120,4185,4935
Guerrero,90 a 94 años,2005,11675,5335,6340
Guerrero,90 a 94 años,2010,14892,6809,8083
Guerrero,90 a 94 años,2020,9187,4039,5148
Guerrero,85 a 89 años,1990,6721,3137,3584
Guerrero,85 a 89 años,1995,7581,3613,3968
Guerrero,85 a 89 años,2000,17112,7872,9240
Guerrero,85 a 89 años,2005,21597,9992,11605
Guerrero,85 a 89 años,2010,26491,12278,14213
Guerrero,85 a 89 años,2020,23532,10376,13156
Guerrero,80 a 84 años,1990,14143,6382,7761
Guerrero,80 a 84 años,1995,14734,6795,7939
Guerrero,80 a 84 años,2000,26950,13153,13797
Guerrero,80 a 84 años,2005,34974,16891,18083
Guerrero,80 a 84 años,2010,43749,20709,23040
Guerrero,80 a 84 años,2020,39210,17897,21313
Guerrero,75 a 79 años,1990,17170,8423,8747
Guerrero,75 a 79 años,1995,20694,10275,10419
Guerrero,75 a 79 años,2000,42207,20193,22014
Guerrero,75 a 79 años,2005,50403,23852,26551
Guerrero,75 a 79 años,2010,66668,31228,35440
Guerrero,75 a 79 años,2020,58071,27472,30599
Guerrero,70 a 74 años,1990,28421,13939,14482
Guerrero,70 a 74 años,1995,35686,17264,18422
Guerrero,70 a 74 años,2000,54139,25200,28939
Guerrero,70 a 74 años,2005,66040,30398,35642
Guerrero,70 a 74 años,2010,72733,33837,38896
Guerrero,70 a 74 años,2020,77444,36646,40798
Guerrero,65 a 69 años,1990,33936,16371,17565
Guerrero,65 a 69 años,1995,42877,20447,22430
Guerrero,65 a 69 años,2000,72841,34344,38497
Guerrero,65 a 69 años,2005,80235,37731,42504
Guerrero,65 a 69 años,2010,89041,42136,46905
Guerrero,65 a 69 años,2020,104196,48671,55525
Guerrero,60 a 64 años,1990,51474,24876,26598
Guerrero,60 a 64 años,1995,63816,30678,33138
Guerrero,60 a 64 años,2000,76908,36481,40427
Guerrero,60 a 64 años,2005,89468,42807,46661
Guerrero,60 a 64 años,2010,110858,53232,57626
Guerrero,60 a 64 años,2020,126765,59295,67470
Guerrero,55 a 59 años,1990,57775,28165,29610
Guerrero,55 a 59 años,1995,67228,32323,34905
Guerrero,55 a 59 años,2000,96611,46272,50339
Guerrero,55 a 59 años,2005,112818,53978,58840
Guerrero,55 a 59 años,2010,137260,64884,72376
Guerrero,55 a 59 años,2020,148972,69264,79708
Guerrero,50 a 54 años,1990,74054,35600,38454
Guerrero,50 a 54 años,1995,86328,41907,44421
Guerrero,50 a 54 años,2000,117329,55640,61689
Guerrero,50 a 54 años,2005,135306,63531,71775
Guerrero,50 a 54 años,2010,158413,73976,84437
Guerrero,50 a 54 años,2020,174072,80393,93679
Guerrero,5 a 9 años,1990,386810,195254,191556
Guerrero,5 a 9 años,1995,399798,202850,196948
Guerrero,5 a 9 años,2000,391873,198055,193818
Guerrero,5 a 9 años,2005,345731,174968,170763
Guerrero,5 a 9 años,2010,353009,179246,173763
Guerrero,5 a 9 años,2020,351010,177163,173847
Guerrero,45 a 49 años,1990,92617,44171,48446
Guerrero,45 a 49 años,1995,106096,51070,55026
Guerrero,45 a 49 años,2000,142041,67300,74741
Guerrero,45 a 49 años,2005,158810,74032,84778
Guerrero,45 a 49 años,2010,178482,83944,94538
Guerrero,45 a 49 años,2020,190778,89571,101207
Guerrero,40 a 44 años,1990,103265,49712,53553
Guerrero,40 a 44 años,1995,126571,61736,64835
Guerrero,40 a 44 años,2000,176165,81594,94571
Guerrero,40 a 44 años,2005,181518,83257,98261
Guerrero,40 a 44 años,2010,211923,99320,112603
Guerrero,40 a 44 años,2020,209120,97642,111478
Guerrero,35 a 39 años,1990,137436,64989,72447
Guerrero,35 a 39 años,1995,165407,78286,87121
Guerrero,35 a 39 años,2000,186082,85746,100336
Guerrero,35 a 39 años,2005,198099,90739,107360
Guerrero,35 a 39 años,2010,223482,104473,119009
Guerrero,35 a 39 años,2020,222157,102989,119168
Guerrero,30 a 34 años,1990,146484,69230,77254
Guerrero,30 a 34 años,1995,177944,84143,93801
Guerrero,30 a 34 años,2000,215653,99525,116128
Guerrero,30 a 34 años,2005,212665,96552,116113
Guerrero,30 a 34 años,2010,237815,111428,126387
Guerrero,30 a 34 años,2020,237976,109644,128332
Guerrero,25 a 29 años,1990,180524,84070,96454
Guerrero,25 a 29 años,1995,205582,96854,108728
Guerrero,25 a 29 años,2000,265129,122169,142960
Guerrero,25 a 29 años,2005,252404,114723,137681
Guerrero,25 a 29 años,2010,290684,137993,152691
Guerrero,25 a 29 años,2020,256191,118352,137839
Guerrero,20 a 24 años,1990,218114,101651,116463
Guerrero,20 a 24 años,1995,265340,126456,138884
Guerrero,20 a 24 años,2000,333331,161191,172140
Guerrero,20 a 24 años,2005,332940,161667,171273
Guerrero,20 a 24 años,2010,372191,184645,187546
Guerrero,20 a 24 años,2020,281967,133690,148277
Guerrero,15 a 19 años,1990,301872,148144,153728
Guerrero,15 a 19 años,1995,336443,166520,169923
Guerrero,15 a 19 años,2000,394613,199865,194748
Guerrero,15 a 19 años,2005,396125,200491,195634
Guerrero,15 a 19 años,2010,393378,198888,194490
Guerrero,15 a 19 años,2020,326540,162620,163920
Guerrero,100 años y más,1990,1094,428,666
Guerrero,100 años y más,1995,894,360,534
Guerrero,100 años y más,2000,2711,1219,1492
Guerrero,100 años y más,2005,2520,1130,1390
Guerrero,100 años y más,2010,2810,1244,1566
Guerrero,100 años y más,2020,1179,470,709
Guerrero,10 a 14 años,1990,370880,187544,183336
Guerrero,10 a 14 años,1995,387415,196670,190745
Guerrero,10 a 14 años,2000,411408,208037,203371
Guerrero,10 a 14 años,2005,377826,190749,187077
Guerrero,10 a 14 años,2010,378197,191053,187144
Guerrero,10 a 14 años,2020,348493,176233,172260
Guerrero,0 a 4 años,1990,361479,182613,178866
Guerrero,0 a 4 años,1995,388050,197290,190760
Guerrero,0 a 4 años,2000,3079649,1491287,1588362
Guerrero,0 a 4 años,2005,3115202,1499453,1615749
Guerrero,0 a 4 años,2010,3388768,1645561,1743207
Guerrero,0 a 4 años,2020,335458,169332,166126
Hidalgo,No especificado,1990,13809,6643,7166
Hidalgo,No especificado,1995,5007,2137,2870
Hidalgo,No especificado,2000,660,227,433
Hidalgo,No especificado,2005,621,204,417
Hidalgo,No especificado,2010,654,235,419
Hidalgo,No especificado,2020,3206,1588,1618
Hidalgo,95 a 99 años,1990,1153,409,744
Hidalgo,95 a 99 años,1995,1473,557,916
Hidalgo,95 a 99 años,2000,3268,1274,1994
Hidalgo,95 a 99 años,2005,3470,1381,2089
Hidalgo,95 a 99 años,2010,4577,1862,2715
Hidalgo,95 a 99 años,2020,3020,1115,1905
Hidalgo,90 a 94 años,1990,2384,862,1522
Hidalgo,90 a 94 años,1995,2712,1043,1669
Hidalgo,90 a 94 años,2000,7406,3139,4267
Hidalgo,90 a 94 años,2005,9117,3974,5143
Hidalgo,90 a 94 años,2010,12043,5139,6904
Hidalgo,90 a 94 años,2020,7213,2878,4335
Hidalgo,85 a 89 años,1990,5340,2254,3086
Hidalgo,85 a 89 años,1995,6056,2564,3492
Hidalgo,85 a 89 años,2000,12770,5727,7043
Hidalgo,85 a 89 años,2005,16502,7413,9089
Hidalgo,85 a 89 años,2010,19997,8912,11085
Hidalgo,85 a 89 años,2020,17421,7713,9708
Hidalgo,80 a 84 años,1990,9644,4127,5517
Hidalgo,80 a 84 años,1995,10546,4619,5927
Hidalgo,80 a 84 años,2000,21911,10518,11393
Hidalgo,80 a 84 años,2005,25653,12155,13498
Hidalgo,80 a 84 años,2010,31279,14642,16637
Hidalgo,80 a 84 años,2020,29997,13534,16463
Hidalgo,75 a 79 años,1990,14328,6797,7531
Hidalgo,75 a 79 años,1995,17386,8437,8949
Hidalgo,75 a 79 años,2000,30440,14494,15946
Hidalgo,75 a 79 años,2005,35516,16901,18615
Hidalgo,75 a 79 años,2010,48068,22456,25612
Hidalgo,75 a 79 años,2020,47263,22656,24607
Hidalgo,70 a 74 años,1990,21014,9901,11113
Hidalgo,70 a 74 años,1995,26160,12722,13438
Hidalgo,70 a 74 años,2000,40119,19103,21016
Hidalgo,70 a 74 años,2005,46738,22345,24393
Hidalgo,70 a 74 años,2010,57669,27765,29904
Hidalgo,70 a 74 años,2020,66179,31397,34782
Hidalgo,65 a 69 años,1990,28339,13645,14694
Hidalgo,65 a 69 años,1995,33606,16024,17582
Hidalgo,65 a 69 años,2000,51719,24910,26809
Hidalgo,65 a 69 años,2005,65005,31058,33947
Hidalgo,65 a 69 años,2010,74476,35915,38561
Hidalgo,65 a 69 años,2020,93011,44117,48894
Hidalgo,60 a 64 años,1990,37433,18053,19380
Hidalgo,60 a 64 años,1995,44554,21660,22894
Hidalgo,60 a 64 años,2000,60808,29879,30929
Hidalgo,60 a 64 años,2005,73161,35672,37489
Hidalgo,60 a 64 años,2010,95265,46282,48983
Hidalgo,60 a 64 años,2020,118929,55713,63216
Hidalgo,55 a 59 años,1990,43533,21769,21764
Hidalgo,55 a 59 años,1995,51647,25527,26120
Hidalgo,55 a 59 años,2000,77766,38145,39621
Hidalgo,55 a 59 años,2005,93857,45771,48086
Hidalgo,55 a 59 años,2010,120304,57248,63056
Hidalgo,55 a 59 años,2020,139795,65244,74551
Hidalgo,50 a 54 años,1990,54437,26964,27473
Hidalgo,50 a 54 años,1995,65824,32702,33122
Hidalgo,50 a 54 años,2000,95309,46488,48821
Hidalgo,50 a 54 años,2005,116547,55512,61035
Hidalgo,50 a 54 años,2010,140325,65837,74488
Hidalgo,50 a 54 años,2020,171679,79935,91744
Hidalgo,5 a 9 años,1990,269371,135688,133683
Hidalgo,5 a 9 años,1995,265590,134122,131468
Hidalgo,5 a 9 años,2000,243558,123609,119949
Hidalgo,5 a 9 años,2005,237423,120784,116639
Hidalgo,5 a 9 años,2010,255202,129514,125688
Hidalgo,5 a 9 años,2020,269553,136027,133526
Hidalgo,45 a 49 años,1990,70768,34915,35853
Hidalgo,45 a 49 años,1995,83345,41453,41892
Hidalgo,45 a 49 años,2000,117852,56602,61250
Hidalgo,45 a 49 años,2005,135441,63506,71935
Hidalgo,45 a 49 años,2010,162857,76199,86658
Hidalgo,45 a 49 años,2020,194567,91193,103374
Hidalgo,40 a 44 años,1990,77683,38622,39061
Hidalgo,40 a 44 años,1995,98208,49155,49053
Hidalgo,40 a 44 años,2000,143447,66909,76538
Hidalgo,40 a 44 años,2005,159174,73325,85849
Hidalgo,40 a 44 años,2010,191131,88478,102653
Hidalgo,40 a 44 años,2020,211048,97725,113323
Hidalgo,35 a 39 años,1990,106107,51450,54657
Hidalgo,35 a 39 años,1995,132294,63858,68436
Hidalgo,35 a 39 años,2000,155351,71301,84050
Hidalgo,35 a 39 años,2005,173306,78284,95022
Hidalgo,35 a 39 años,2010,197047,90262,106785
Hidalgo,35 a 39 años,2020,221410,101835,119575
Hidalgo,30 a 34 años,1990,117480,56395,61085
Hidalgo,30 a 34 años,1995,141617,67019,74598
Hidalgo,30 a 34 años,2000,172960,78718,94242
Hidalgo,30 a 34 años,2005,175226,78011,97215
Hidalgo,30 a 34 años,2010,201034,91783,109251
Hidalgo,30 a 34 años,2020,224226,102706,121520
Hidalgo,25 a 29 años,1990,137762,64262,73500
Hidalgo,25 a 29 años,1995,162352,77241,85111
Hidalgo,25 a 29 años,2000,195771,88949,106822
Hidalgo,25 a 29 años,2005,196494,88134,108360
Hidalgo,25 a 29 años,2010,226170,106172,119998
Hidalgo,25 a 29 años,2020,231124,108338,122786
Hidalgo,20 a 24 años,1990,160396,75252,85144
Hidalgo,20 a 24 años,1995,201620,96765,104855
Hidalgo,20 a 24 años,2000,235368,114428,120940
Hidalgo,20 a 24 años,2005,237675,115331,122344
Hidalgo,20 a 24 años,2010,269602,134493,135109
Hidalgo,20 a 24 años,2020,238187,116241,121946
Hidalgo,15 a 19 años,1990,210593,105116,105477
Hidalgo,15 a 19 años,1995,239592,119944,119648
Hidalgo,15 a 19 años,2000,271378,137272,134106
Hidalgo,15 a 19 años,2005,270650,136955,133695
Hidalgo,15 a 19 años,2010,263026,133304,129722
Hidalgo,15 a 19 años,2020,272506,137426,135080
Hidalgo,100 años y más,1990,728,252,476
Hidalgo,100 años y más,1995,514,148,366
Hidalgo,100 años y más,2000,1835,686,1149
Hidalgo,100 años y más,2005,1703,628,1075
Hidalgo,100 años y más,2010,1952,716,1236
Hidalgo,100 años y más,2020,642,192,450
Hidalgo,10 a 14 años,1990,260049,131741,128308
Hidalgo,10 a 14 años,1995,269753,136420,133333
Hidalgo,10 a 14 años,2000,277830,140645,137185
Hidalgo,10 a 14 años,2005,243185,123336,119849
Hidalgo,10 a 14 años,2010,271181,137456,133725
Hidalgo,10 a 14 años,2020,283676,143492,140184
Hidalgo,0 a 4 años,1990,246015,124021,121994
Hidalgo,0 a 4 años,1995,252617,128449,124168
Hidalgo,0 a 4 años,2000,2235591,1081993,1153598
Hidalgo,0 a 4 años,2005,2345514,1125188,1220326
Hidalgo,0 a 4 años,2010,2665018,1285222,1379796
Hidalgo,0 a 4 años,2020,238189,120314,117875
Jalisco,No especificado,1990,46312,22256,24056
Jalisco,No especificado,1995,16393,8464,7929
Jalisco,No especificado,2000,1097,427,670
Jalisco,No especificado,2005,1027,409,618
Jalisco,No especificado,2010,1084,415,669
Jalisco,No especificado,2020,51051,25503,25548
Jalisco,95 a 99 años,1990,2805,1181,1624
Jalisco,95 a 99 años,1995,3510,1477,2033
Jalisco,95 a 99 años,2000,9701,4103,5598
Jalisco,95 a 99 años,2005,11502,4926,6576
Jalisco,95 a 99 años,2010,13596,5628,7968
Jalisco,95 a 99 años,2020,6381,2422,3959
Jalisco,90 a 94 años,1990,7097,2979,4118
Jalisco,90 a 94 años,1995,8299,3529,4770
Jalisco,90 a 94 años,2000,24151,10772,13379
Jalisco,90 a 94 años,2005,27217,12006,15211
Jalisco,90 a 94 años,2010,32720,14255,18465
Jalisco,90 a 94 años,2020,17725,7062,10663
Jalisco,85 a 89 años,1990,17241,7564,9677
Jalisco,85 a 89 años,1995,19954,8852,11102
Jalisco,85 a 89 años,2000,39463,17838,21625
Jalisco,85 a 89 años,2005,48147,21475,26672
Jalisco,85 a 89 años,2010,53964,23768,30196
Jalisco,85 a 89 años,2020,41507,17843,23664
Jalisco,80 a 84 años,1990,30814,13802,17012
Jalisco,80 a 84 años,1995,36385,16501,19884
Jalisco,80 a 84 años,2000,63716,30017,33699
Jalisco,80 a 84 años,2005,69383,32186,37197
Jalisco,80 a 84 años,2010,80747,37383,43364
Jalisco,80 a 84 años,2020,76495,33970,42525
Jalisco,75 a 79 años,1990,47547,22409,25138
Jalisco,75 a 79 años,1995,53066,25061,28005
Jalisco,75 a 79 años,2000,84182,39184,44998
Jalisco,75 a 79 años,2005,96044,44817,51227
Jalisco,75 a 79 años,2010,118204,55172,63032
Jalisco,75 a 79 años,2020,120885,56892,63993
Jalisco,70 a 74 años,1990,64662,30562,34100
Jalisco,70 a 74 años,1995,79247,37374,41873
Jalisco,70 a 74 años,2000,108075,50693,57382
Jalisco,70 a 74 años,2005,126101,59336,66765
Jalisco,70 a 74 años,2010,155337,73976,81361
Jalisco,70 a 74 años,2020,181420,84464,96956
Jalisco,65 a 69 años,1990,85330,40115,45215
Jalisco,65 a 69 años,1995,95384,44832,50552
Jalisco,65 a 69 años,2000,140629,66144,74485
Jalisco,65 a 69 años,2005,172579,81797,90782
Jalisco,65 a 69 años,2010,210465,99337,111128
Jalisco,65 a 69 años,2020,240553,111583,128970
Jalisco,60 a 64 años,1990,105816,49067,56749
Jalisco,60 a 64 años,1995,125183,58712,66471
Jalisco,60 a 64 años,2000,169779,81869,87910
Jalisco,60 a 64 años,2005,208005,99191,108814
Jalisco,60 a 64 años,2010,254380,120383,133997
Jalisco,60 a 64 años,2020,313011,144991,168020
Jalisco,55 a 59 años,1990,120026,56950,63076
Jalisco,55 a 59 años,1995,143341,68852,74489
Jalisco,55 a 59 años,2000,224975,107972,117003
Jalisco,55 a 59 años,2005,267921,125979,141942
Jalisco,55 a 59 años,2010,324277,152109,172168
Jalisco,55 a 59 años,2020,357080,167535,189545
Jalisco,50 a 54 años,1990,151319,71875,79444
Jalisco,50 a 54 años,1995,192416,93304,99112
Jalisco,50 a 54 años,2000,264177,125130,139047
Jalisco,50 a 54 años,2005,318734,149555,169179
Jalisco,50 a 54 años,2010,371541,175474,196067
Jalisco,50 a 54 años,2020,444689,210067,234622
Jalisco,5 a 9 años,1990,695463,352079,343384
Jalisco,5 a 9 años,1995,717968,364579,353389
Jalisco,5 a 9 años,2000,703272,357599,345673
Jalisco,5 a 9 años,2005,674285,342642,331643
Jalisco,5 a 9 años,2010,694948,353751,341197
Jalisco,5 a 9 años,2020,718100,363911,354189
Jalisco,45 a 49 años,1990,190247,92271,97976
Jalisco,45 a 49 años,1995,237708,115217,122491
Jalisco,45 a 49 años,2000,334653,158651,176002
Jalisco,45 a 49 años,2005,379829,179031,200798
Jalisco,45 a 49 años,2010,446601,213669,232932
Jalisco,45 a 49 años,2020,511537,248266,263271
Jalisco,40 a 44 años,1990,231557,111269,120288
Jalisco,40 a 44 años,1995,291118,139687,151431
Jalisco,40 a 44 años,2000,397738,186637,211101
Jalisco,40 a 44 años,2005,448698,211444,237254
Jalisco,40 a 44 años,2010,535234,258270,276964
Jalisco,40 a 44 años,2020,549859,266310,283549
Jalisco,35 a 39 años,1990,289603,136230,153373
Jalisco,35 a 39 años,1995,365641,173020,192621
Jalisco,35 a 39 años,2000,453186,211880,241306
Jalisco,35 a 39 años,2005,509541,240566,268975
Jalisco,35 a 39 años,2010,548117,263140,284977
Jalisco,35 a 39 años,2020,602903,295336,307567
Jalisco,30 a 34 años,1990,337131,156725,180406
Jalisco,30 a 34 años,1995,413098,193534,219564
Jalisco,30 a 34 años,2000,529194,248483,280711
Jalisco,30 a 34 años,2005,523866,246599,277267
Jalisco,30 a 34 años,2010,592033,287723,304310
Jalisco,30 a 34 años,2020,639006,312917,326089
Jalisco,25 a 29 años,1990,390128,179028,211100
Jalisco,25 a 29 años,1995,482529,225997,256532
Jalisco,25 a 29 años,2000,589706,276164,313542
Jalisco,25 a 29 años,2005,601671,285876,315795
Jalisco,25 a 29 años,2010,669088,329145,339943
Jalisco,25 a 29 años,2020,668334,331070,337264
Jalisco,20 a 24 años,1990,491687,224235,267452
Jalisco,20 a 24 años,1995,615402,291850,323552
Jalisco,20 a 24 años,2000,673570,331655,341915
Jalisco,20 a 24 años,2005,669724,330944,338780
Jalisco,20 a 24 años,2010,715003,360175,354828
Jalisco,20 a 24 años,2020,704359,351982,352377
Jalisco,15 a 19 años,1990,643430,311635,331795
Jalisco,15 a 19 años,1995,676896,333050,343846
Jalisco,15 a 19 años,2000,708813,358780,350033
Jalisco,15 a 19 años,2005,697206,354242,342964
Jalisco,15 a 19 años,2010,714393,362097,352296
Jalisco,15 a 19 años,2020,716259,362796,353463
Jalisco,100 años y más,1990,1158,462,696
Jalisco,100 años y más,1995,820,288,532
Jalisco,100 años y más,2000,4405,1819,2586
Jalisco,100 años y más,2005,4526,1778,2748
Jalisco,100 años y más,2010,5206,2133,3073
Jalisco,100 años y más,2020,1108,393,715
Jalisco,10 a 14 años,1990,681667,342191,339476
Jalisco,10 a 14 años,1995,715201,362767,352434
Jalisco,10 a 14 años,2000,720270,365438,354832
Jalisco,10 a 14 años,2005,688681,349996,338685
Jalisco,10 a 14 años,2010,727075,369308,357767
Jalisco,10 a 14 años,2020,714906,364020,350886
Jalisco,0 a 4 años,1990,671649,340007,331642
Jalisco,0 a 4 años,1995,701617,356974,344643
Jalisco,0 a 4 años,2000,6322002,3070241,3251761
Jalisco,0 a 4 años,2005,6752113,3278822,3473291
Jalisco,0 a 4 años,2010,7350682,3600641,3750041
Jalisco,0 a 4 años,2020,670983,339122,331861
México,No especificado,1990,22261,10925,11336
México,No especificado,1995,24730,11833,12897
México,No especificado,2000,1792,656,1136
México,No especificado,2005,1334,376,958
México,No especificado,2010,1378,424,954
México,No especificado,2020,8227,4027,4200
México,95 a 99 años,1990,3497,1249,2248
México,95 a 99 años,1995,4715,1668,3047
México,95 a 99 años,2000,10206,3640,6566
México,95 a 99 años,2005,11029,3929,7100
México,95 a 99 años,2010,14612,5459,9153
México,95 a 99 años,2020,9294,3120,6174
México,90 a 94 años,1990,7312,2595,4717
México,90 a 94 años,1995,8673,3229,5444
México,90 a 94 años,2000,25874,10056,15818
México,90 a 94 años,2005,31282,12505,18777
México,90 a 94 años,2010,44498,17985,26513
México,90 a 94 años,2020,26950,9949,17001
México,85 a 89 años,1990,19588,7689,11899
México,85 a 89 años,1995,21492,8568,12924
México,85 a 89 años,2000,41618,17412,24206
México,85 a 89 años,2005,61530,26388,35142
México,85 a 89 años,2010,78893,33293,45600
México,85 a 89 años,2020,71307,28844,42463
México,80 a 84 años,1990,31272,12980,18292
México,80 a 84 años,1995,34930,14403,20527
México,80 a 84 años,2000,84377,38231,46146
México,80 a 84 años,2005,102977,46177,56800
México,80 a 84 años,2010,129423,58326,71097
México,80 a 84 años,2020,130480,56251,74229
México,75 a 79 años,1990,49615,21815,27800
México,75 a 79 años,1995,59674,27032,32642
México,75 a 79 años,2000,123108,56031,67077
México,75 a 79 años,2005,156324,71808,84516
México,75 a 79 años,2010,200542,91438,109104
México,75 a 79 años,2020,212562,97227,115335
México,70 a 74 años,1990,69215,31524,37691
México,70 a 74 años,1995,101342,47057,54285
México,70 a 74 años,2000,178159,82133,96026
México,70 a 74 años,2005,215924,100467,115457
México,70 a 74 años,2010,270138,126755,143383
México,70 a 74 años,2020,330905,152248,178657
México,65 a 69 años,1990,112907,52962,59945
México,65 a 69 años,1995,145024,67125,77899
México,65 a 69 años,2000,242540,114932,127608
México,65 a 69 años,2005,305945,145437,160508
México,65 a 69 años,2010,392349,185672,206677
México,65 a 69 años,2020,475398,221241,254157
México,60 a 64 años,1990,156005,73584,82421
México,60 a 64 años,1995,204472,96996,107476
México,60 a 64 años,2000,303755,147106,156649
México,60 a 64 años,2005,388919,187632,201287
México,60 a 64 años,2010,509884,244538,265346
México,60 a 64 años,2020,661100,307001,354099
México,55 a 59 años,1990,200166,97577,102589
México,55 a 59 años,1995,251155,122363,128792
México,55 a 59 años,2000,422987,206575,216412
México,55 a 59 años,2005,539308,259710,279598
México,55 a 59 años,2010,695328,329825,365503
México,55 a 59 años,2020,795711,373977,421734
México,50 a 54 años,1990,264020,129860,134160
México,50 a 54 años,1995,349220,172646,176574
México,50 a 54 años,2000,535083,259150,275933
México,50 a 54 años,2005,682173,325717,356456
México,50 a 54 años,2010,831164,395154,436010
México,50 a 54 años,2020,1007077,473362,533715
México,5 a 9 años,1990,1284167,647646,636521
México,5 a 9 años,1995,1382651,701280,681371
México,5 a 9 años,2000,1366320,693821,672499
México,5 a 9 años,2005,1373064,697889,675175
México,5 a 9 años,2010,1426612,723127,703485
México,5 a 9 años,2020,1381132,699573,681559
México,45 a 49 años,1990,348862,173369,175493
México,45 a 49 años,1995,457065,225645,231420
México,45 a 49 años,2000,706988,341811,365177
México,45 a 49 años,2005,839324,402414,436910
México,45 a 49 años,2010,1003492,478370,525122
México,45 a 49 años,2020,1145882,542558,603324
México,40 a 44 años,1990,429384,213167,216217
México,40 a 44 años,1995,586683,290564,296119
México,40 a 44 años,2000,883172,420989,462183
México,40 a 44 años,2005,1016457,483846,532611
México,40 a 44 años,2010,1193988,566526,627462
México,40 a 44 años,2020,1197089,563714,633375
México,35 a 39 años,1990,584990,287047,297943
México,35 a 39 años,1995,793800,384902,408898
México,35 a 39 años,2000,1008308,480221,528087
México,35 a 39 años,2005,1147320,541872,605448
México,35 a 39 años,2010,1198515,565928,632587
México,35 a 39 años,2020,1254296,596686,657610
México,30 a 34 años,1990,709181,341203,367978
México,30 a 34 años,1995,913299,439328,473971
México,30 a 34 años,2000,1154041,548872,605169
México,30 a 34 años,2005,1152407,546014,606393
México,30 a 34 años,2010,1233854,591831,642023
México,30 a 34 años,2020,1283264,615018,668246
México,25 a 29 años,1990,834509,399918,434591
México,25 a 29 años,1995,1058142,511944,546198
México,25 a 29 años,2000,1250900,600382,650518
México,25 a 29 años,2005,1250151,601037,649114
México,25 a 29 años,2010,1364380,668827,695553
México,25 a 29 años,2020,1367527,667933,699594
México,20 a 24 años,1990,1010653,488297,522356
México,20 a 24 años,1995,1295228,629684,665544
México,20 a 24 años,2000,1307977,645046,662931
México,20 a 24 años,2005,1334112,663064,671048
México,20 a 24 años,2010,1467148,734320,732828
México,20 a 24 años,2020,1415159,705458,709701
México,15 a 19 años,1990,1198496,592244,606252
México,15 a 19 años,1995,1305765,648259,657506
México,15 a 19 años,2000,1363554,689319,674235
México,15 a 19 años,2005,1410691,713138,697553
México,15 a 19 años,2010,1429028,723622,705406
México,15 a 19 años,2020,1476665,747531,729134
México,100 años y más,1990,1510,456,1054
México,100 años y más,1995,1000,259,741
México,100 años y más,2000,6030,2107,3923
México,100 años y más,2005,5264,1772,3492
México,100 años y más,2010,5814,1925,3889
México,100 años y más,2020,1458,424,1034
México,10 a 14 años,1990,1248189,626149,622040
México,10 a 14 años,1995,1344420,678340,666080
México,10 a 14 años,2000,1447047,731860,715187
México,10 a 14 años,2005,1362065,691997,670068
México,10 a 14 años,2010,1498274,760231,738043
México,10 a 14 años,2020,1464549,740376,724173
México,0 a 4 años,1990,1229996,622293,607703
México,0 a 4 años,1995,1364484,692929,671555
México,0 a 4 años,2000,13096686,6407213,6689473
México,0 a 4 años,2005,14007495,6832822,7174673
México,0 a 4 años,2010,15175862,7396986,7778876
México,0 a 4 años,2020,1276386,644777,631609
Michoacán de Ocampo,No especificado,1990,42379,20447,21932
Michoacán de Ocampo,No especificado,1995,13660,6449,7211
Michoacán de Ocampo,No especificado,2000,1216,537,679
Michoacán de Ocampo,No especificado,2005,1046,427,619
Michoacán de Ocampo,No especificado,2010,1046,451,595
Michoacán de Ocampo,No especificado,2020,3530,1746,1784
Michoacán de Ocampo,95 a 99 años,1990,2240,952,1288
Michoacán de Ocampo,95 a 99 años,1995,2925,1289,1636
Michoacán de Ocampo,95 a 99 años,2000,6983,3189,3794
Michoacán de Ocampo,95 a 99 años,2005,7330,3314,4016
Michoacán de Ocampo,95 a 99 años,2010,8949,4017,4932
Michoacán de Ocampo,95 a 99 años,2020,5246,2242,3004
Michoacán de Ocampo,90 a 94 años,1990,5454,2435,3019
Michoacán de Ocampo,90 a 94 años,1995,5932,2663,3269
Michoacán de Ocampo,90 a 94 años,2000,15131,7120,8011
Michoacán de Ocampo,90 a 94 años,2005,17681,8382,9299
Michoacán de Ocampo,90 a 94 años,2010,23160,10696,12464
Michoacán de Ocampo,90 a 94 años,2020,13255,5868,7387
Michoacán de Ocampo,85 a 89 años,1990,11618,5474,6144
Michoacán de Ocampo,85 a 89 años,1995,13194,6283,6911
Michoacán de Ocampo,85 a 89 años,2000,25242,11868,13374
Michoacán de Ocampo,85 a 89 años,2005,33279,15582,17697
Michoacán de Ocampo,85 a 89 años,2010,40032,18583,21449
Michoacán de Ocampo,85 a 89 años,2020,30976,13989,16987
Michoacán de Ocampo,80 a 84 años,1990,22110,10286,11824
Michoacán de Ocampo,80 a 84 años,1995,23993,11300,12693
Michoacán de Ocampo,80 a 84 años,2000,42177,20718,21459
Michoacán de Ocampo,80 a 84 años,2005,50678,24637,26041
Michoacán de Ocampo,80 a 84 años,2010,58813,28096,30717
Michoacán de Ocampo,80 a 84 años,2020,51154,23473,27681
Michoacán de Ocampo,75 a 79 años,1990,28987,14307,14680
Michoacán de Ocampo,75 a 79 años,1995,32765,16287,16478
Michoacán de Ocampo,75 a 79 años,2000,61639,29772,31867
Michoacán de Ocampo,75 a 79 años,2005,69195,32843,36352
Michoacán de Ocampo,75 a 79 años,2010,83990,39343,44647
Michoacán de Ocampo,75 a 79 años,2020,74938,35694,39244
Michoacán de Ocampo,70 a 74 años,1990,42296,20996,21300
Michoacán de Ocampo,70 a 74 años,1995,54355,26750,27605
Michoacán de Ocampo,70 a 74 años,2000,75177,35293,39884
Michoacán de Ocampo,70 a 74 años,2005,84325,39858,44467
Michoacán de Ocampo,70 a 74 años,2010,96347,45789,50558
Michoacán de Ocampo,70 a 74 años,2020,106332,50515,55817
Michoacán de Ocampo,65 a 69 años,1990,53580,25886,27694
Michoacán de Ocampo,65 a 69 años,1995,65207,30972,34235
Michoacán de Ocampo,65 a 69 años,2000,94498,44526,49972
Michoacán de Ocampo,65 a 69 años,2005,104898,49077,55821
Michoacán de Ocampo,65 a 69 años,2010,122951,58031,64920
Michoacán de Ocampo,65 a 69 años,2020,140009,66427,73582
Michoacán de Ocampo,60 a 64 años,1990,75014,35904,39110
Michoacán de Ocampo,60 a 64 años,1995,88981,42632,46349
Michoacán de Ocampo,60 a 64 años,2000,102326,48464,53862
Michoacán de Ocampo,60 a 64 años,2005,120402,57263,63139
Michoacán de Ocampo,60 a 64 años,2010,147873,71049,76824
Michoacán de Ocampo,60 a 64 años,2020,178844,83238,95606
Michoacán de Ocampo,55 a 59 años,1990,81634,39451,42183
Michoacán de Ocampo,55 a 59 años,1995,91798,43955,47843
Michoacán de Ocampo,55 a 59 años,2000,132493,63146,69347
Michoacán de Ocampo,55 a 59 años,2005,153673,72818,80855
Michoacán de Ocampo,55 a 59 años,2010,188305,88214,100091
Michoacán de Ocampo,55 a 59 años,2020,202399,94210,108189
Michoacán de Ocampo,50 a 54 años,1990,101422,48461,52961
Michoacán de Ocampo,50 a 54 años,1995,118272,56873,61399
Michoacán de Ocampo,50 a 54 años,2000,154267,73326,80941
Michoacán de Ocampo,50 a 54 años,2005,182586,85391,97195
Michoacán de Ocampo,50 a 54 años,2010,212627,99106,113521
Michoacán de Ocampo,50 a 54 años,2020,243599,113217,130382
Michoacán de Ocampo,5 a 9 años,1990,491674,248142,243532
Michoacán de Ocampo,5 a 9 años,1995,499020,252636,246384
Michoacán de Ocampo,5 a 9 años,2000,453339,229097,224242
Michoacán de Ocampo,5 a 9 años,2005,400054,202915,197139
Michoacán de Ocampo,5 a 9 años,2010,425698,215617,210081
Michoacán de Ocampo,5 a 9 años,2020,441618,223382,218236
Michoacán de Ocampo,45 a 49 años,1990,118842,56801,62041
Michoacán de Ocampo,45 a 49 años,1995,141762,68441,73321
Michoacán de Ocampo,45 a 49 años,2000,196428,92879,103549
Michoacán de Ocampo,45 a 49 años,2005,216455,100356,116099
Michoacán de Ocampo,45 a 49 años,2010,247704,115521,132183
Michoacán de Ocampo,45 a 49 años,2020,270544,129380,141164
Michoacán de Ocampo,40 a 44 años,1990,139854,67100,72754
Michoacán de Ocampo,40 a 44 años,1995,173986,84892,89094
Michoacán de Ocampo,40 a 44 años,2000,233456,107652,125804
Michoacán de Ocampo,40 a 44 años,2005,247470,112596,134874
Michoacán de Ocampo,40 a 44 años,2010,290448,136834,153614
Michoacán de Ocampo,40 a 44 años,2020,299299,142585,156714
Michoacán de Ocampo,35 a 39 años,1990,176749,84247,92502
Michoacán de Ocampo,35 a 39 años,1995,221033,104658,116375
Michoacán de Ocampo,35 a 39 años,2000,255792,115836,139956
Michoacán de Ocampo,35 a 39 años,2005,273154,124017,149137
Michoacán de Ocampo,35 a 39 años,2010,303108,141058,162050
Michoacán de Ocampo,35 a 39 años,2020,318438,151597,166841
Michoacán de Ocampo,30 a 34 años,1990,203845,95021,108824
Michoacán de Ocampo,30 a 34 años,1995,244357,114243,130114
Michoacán de Ocampo,30 a 34 años,2000,294099,132374,161725
Michoacán de Ocampo,30 a 34 años,2005,284690,126561,158129
Michoacán de Ocampo,30 a 34 años,2010,322064,150160,171904
Michoacán de Ocampo,30 a 34 años,2020,345272,162946,182326
Michoacán de Ocampo,25 a 29 años,1990,240995,110101,130894
Michoacán de Ocampo,25 a 29 años,1995,281231,128989,152242
Michoacán de Ocampo,25 a 29 años,2000,357857,159888,197969
Michoacán de Ocampo,25 a 29 años,2005,332440,147596,184844
Michoacán de Ocampo,25 a 29 años,2010,392338,185190,207148
Michoacán de Ocampo,25 a 29 años,2020,367568,176271,191297
Michoacán de Ocampo,20 a 24 años,1990,311727,139326,172401
Michoacán de Ocampo,20 a 24 años,1995,370671,171442,199229
Michoacán de Ocampo,20 a 24 años,2000,436043,207543,228500
Michoacán de Ocampo,20 a 24 años,2005,423624,202977,220647
Michoacán de Ocampo,20 a 24 años,2010,453827,224452,229375
Michoacán de Ocampo,20 a 24 años,2020,390431,191587,198844
Michoacán de Ocampo,15 a 19 años,1990,431353,206567,224786
Michoacán de Ocampo,15 a 19 años,1995,457894,222492,235402
Michoacán de Ocampo,15 a 19 años,2000,498316,251262,247054
Michoacán de Ocampo,15 a 19 años,2005,462479,233342,229137
Michoacán de Ocampo,15 a 19 años,2010,443721,223553,220168
Michoacán de Ocampo,15 a 19 años,2020,407743,204821,202922
Michoacán de Ocampo,100 años y más,1990,1287,490,797
Michoacán de Ocampo,100 años y más,1995,931,367,564
Michoacán de Ocampo,100 años y más,2000,3764,1592,2172
Michoacán de Ocampo,100 años y más,2005,3683,1616,2067
Michoacán de Ocampo,100 años y más,2010,3839,1652,2187
Michoacán de Ocampo,100 años y más,2020,945,396,549
Michoacán de Ocampo,10 a 14 años,1990,496659,249951,246708
Michoacán de Ocampo,10 a 14 años,1995,501490,253564,247926
Michoacán de Ocampo,10 a 14 años,2000,492453,248571,243882
Michoacán de Ocampo,10 a 14 años,2005,426654,215699,210955
Michoacán de Ocampo,10 a 14 años,2010,434860,220017,214843
Michoacán de Ocampo,10 a 14 años,2020,426869,215932,210937
Michoacán de Ocampo,0 a 4 años,1990,468480,236418,232062
Michoacán de Ocampo,0 a 4 años,1995,467147,236928,230219
Michoacán de Ocampo,0 a 4 años,2000,3985667,1911078,2074589
Michoacán de Ocampo,0 a 4 años,2005,3966073,1892377,2073696
Michoacán de Ocampo,0 a 4 años,2010,4351037,2102109,2248928
Michoacán de Ocampo,0 a 4 años,2020,429837,216825,213012
Morelos,No especificado,1990,3901,1873,2028
Morelos,No especificado,1995,1902,877,1025
Morelos,No especificado,2000,409,154,255
Morelos,No especificado,2005,390,157,233
Morelos,No especificado,2010,327,136,191
Morelos,No especificado,2020,948,459,489
Morelos,95 a 99 años,1990,680,291,389
Morelos,95 a 99 años,1995,1076,477,599
Morelos,95 a 99 años,2000,2081,912,1169
Morelos,95 a 99 años,2005,2162,909,1253
Morelos,95 a 99 años,2010,2702,1147,1555
Morelos,95 a 99 años,2020,1844,707,1137
Morelos,90 a 94 años,1990,1671,734,937
Morelos,90 a 94 años,1995,1918,851,1067
Morelos,90 a 94 años,2000,4953,2138,2815
Morelos,90 a 94 años,2005,5851,2574,3277
Morelos,90 a 94 años,2010,8567,3862,4705
Morelos,90 a 94 años,2020,5327,2165,3162
Morelos,85 a 89 años,1990,3888,1800,2088
Morelos,85 a 89 años,1995,4469,1979,2490
Morelos,85 a 89 años,2000,7620,3490,4130
Morelos,85 a 89 años,2005,11620,5406,6214
Morelos,85 a 89 años,2010,14917,6621,8296
Morelos,85 a 89 años,2020,13278,5724,7554
Morelos,80 a 84 años,1990,6335,2812,3523
Morelos,80 a 84 años,1995,6555,2937,3618
Morelos,80 a 84 años,2000,15196,7330,7866
Morelos,80 a 84 años,2005,19198,9080,10118
Morelos,80 a 84 años,2010,23535,10876,12659
Morelos,80 a 84 años,2020,21954,9791,12163
Morelos,75 a 79 años,1990,8825,4105,4720
Morelos,75 a 79 años,1995,10844,5315,5529
Morelos,75 a 79 años,2000,22033,10422,11611
Morelos,75 a 79 años,2005,26836,12445,14391
Morelos,75 a 79 años,2010,32988,15169,17819
Morelos,75 a 79 años,2020,33189,15608,17581
Morelos,70 a 74 años,1990,11909,5750,6159
Morelos,70 a 74 años,1995,18175,8942,9233
Morelos,70 a 74 años,2000,30268,14059,16209
Morelos,70 a 74 años,2005,33653,15527,18126
Morelos,70 a 74 años,2010,40104,18850,21254
Morelos,70 a 74 años,2020,47846,22462,25384
Morelos,65 a 69 años,1990,19143,9250,9893
Morelos,65 a 69 años,1995,25504,11976,13528
Morelos,65 a 69 años,2000,36295,16989,19306
Morelos,65 a 69 años,2005,43128,20379,22749
Morelos,65 a 69 años,2010,53604,25556,28048
Morelos,65 a 69 años,2020,65650,30758,34892
Morelos,60 a 64 años,1990,25391,12214,13177
Morelos,60 a 64 años,1995,33014,15730,17284
Morelos,60 a 64 años,2000,41813,19884,21929
Morelos,60 a 64 años,2005,51112,24477,26635
Morelos,60 a 64 años,2010,66904,31856,35048
Morelos,60 a 64 años,2020,84475,39123,45352
Morelos,55 a 59 años,1990,31036,14823,16213
Morelos,55 a 59 años,1995,36749,17581,19168
Morelos,55 a 59 años,2000,53966,26075,27891
Morelos,55 a 59 años,2005,67341,32058,35283
Morelos,55 a 59 años,2010,86282,40293,45989
Morelos,55 a 59 años,2020,96124,44357,51767
Morelos,50 a 54 años,1990,36413,17358,19055
Morelos,50 a 54 años,1995,46219,22458,23761
Morelos,50 a 54 años,2000,66776,32002,34774
Morelos,50 a 54 años,2005,81012,37708,43304
Morelos,50 a 54 años,2010,97105,45411,51694
Morelos,50 a 54 años,2020,114284,52588,61696
Morelos,5 a 9 años,1990,151548,76657,74891
Morelos,5 a 9 años,1995,166248,84621,81627
Morelos,5 a 9 años,2000,160901,81500,79401
Morelos,5 a 9 años,2005,150281,76612,73669
Morelos,5 a 9 años,2010,155669,79434,76235
Morelos,5 a 9 años,2020,158935,80637,78298
Morelos,45 a 49 años,1990,44861,21488,23373
Morelos,45 a 49 años,1995,58154,28428,29726
Morelos,45 a 49 años,2000,84779,40113,44666
Morelos,45 a 49 años,2005,94307,44081,50226
Morelos,45 a 49 años,2010,111381,51504,59877
Morelos,45 a 49 años,2020,124378,58030,66348
Morelos,40 a 44 años,1990,51951,25363,26588
Morelos,40 a 44 años,1995,72003,35431,36572
Morelos,40 a 44 años,2000,100957,46951,54006
Morelos,40 a 44 años,2005,108333,49588,58745
Morelos,40 a 44 años,2010,129072,59870,69202
Morelos,40 a 44 años,2020,130539,60716,69823
Morelos,35 a 39 años,1990,69744,33847,35897
Morelos,35 a 39 años,1995,95595,45429,50166
Morelos,35 a 39 años,2000,109174,50137,59037
Morelos,35 a 39 años,2005,118659,54302,64357
Morelos,35 a 39 años,2010,128812,59712,69100
Morelos,35 a 39 años,2020,135994,63749,72245
Morelos,30 a 34 años,1990,80162,37720,42442
Morelos,30 a 34 años,1995,103465,48938,54527
Morelos,30 a 34 años,2000,123189,56284,66905
Morelos,30 a 34 años,2005,119236,54001,65235
Morelos,30 a 34 años,2010,133544,62528,71016
Morelos,30 a 34 años,2020,143404,67970,75434
Morelos,25 a 29 años,1990,92584,43917,48667
Morelos,25 a 29 años,1995,117551,55332,62219
Morelos,25 a 29 años,2000,137988,63439,74549
Morelos,25 a 29 años,2005,134191,62002,72189
Morelos,25 a 29 años,2010,155671,75194,80477
Morelos,25 a 29 años,2020,154595,74612,79983
Morelos,20 a 24 años,1990,112583,52506,60077
Morelos,20 a 24 años,1995,147558,69809,77749
Morelos,20 a 24 años,2000,156544,76095,80449
Morelos,20 a 24 años,2005,155301,76688,78613
Morelos,20 a 24 años,2010,175625,87725,87900
Morelos,20 a 24 años,2020,162146,79566,82580
Morelos,15 a 19 años,1990,145197,70866,74331
Morelos,15 a 19 años,1995,161301,79242,82059
Morelos,15 a 19 años,2000,166002,84615,81387
Morelos,15 a 19 años,2005,168541,85250,83291
Morelos,15 a 19 años,2010,167487,84822,82665
Morelos,15 a 19 años,2020,166654,84628,82026
Morelos,100 años y más,1990,303,117,186
Morelos,100 años y más,1995,251,79,172
Morelos,100 años y más,2000,1260,541,719
Morelos,100 años y más,2005,1104,452,652
Morelos,100 años y más,2010,1134,464,670
Morelos,100 años y más,2020,340,126,214
Morelos,10 a 14 años,1990,153841,77268,76573
Morelos,10 a 14 años,1995,166885,84508,82377
Morelos,10 a 14 años,2000,173589,87866,85723
Morelos,10 a 14 años,2005,157253,79931,77322
Morelos,10 a 14 años,2010,166908,85100,81808
Morelos,10 a 14 años,2020,164177,83391,80786
Morelos,0 a 4 años,1990,143093,73026,70067
Morelos,0 a 4 años,1995,167226,85141,82085
Morelos,0 a 4 años,2000,1555296,750799,804497
Morelos,0 a 4 años,2005,1612899,775311,837588
Morelos,0 a 4 años,2010,1777227,858588,918639
Morelos,0 a 4 años,2020,145439,73680,71759
Nayarit,No especificado,1990,9725,4852,4873
Nayarit,No especificado,1995,1652,805,847
Nayarit,No especificado,2000,238,110,128
Nayarit,No especificado,2005,222,109,113
Nayarit,No especificado,2010,247,134,113
Nayarit,No especificado,2020,1168,572,596
Nayarit,95 a 99 años,1990,465,227,238
Nayarit,95 a 99 años,1995,633,309,324
Nayarit,95 a 99 años,2000,1450,682,768
Nayarit,95 a 99 años,2005,1694,790,904
Nayarit,95 a 99 años,2010,2113,944,1169
Nayarit,95 a 99 años,2020,996,433,563
Nayarit,90 a 94 años,1990,1121,518,603
Nayarit,90 a 94 años,1995,1252,601,651
Nayarit,90 a 94 años,2000,3838,1826,2012
Nayarit,90 a 94 años,2005,4184,1991,2193
Nayarit,90 a 94 años,2010,5111,2390,2721
Nayarit,90 a 94 años,2020,2773,1179,1594
Nayarit,85 a 89 años,1990,2657,1299,1358
Nayarit,85 a 89 años,1995,3085,1483,1602
Nayarit,85 a 89 años,2000,6070,2902,3168
Nayarit,85 a 89 años,2005,7228,3538,3690
Nayarit,85 a 89 años,2010,8690,4150,4540
Nayarit,85 a 89 años,2020,7093,3310,3783
Nayarit,80 a 84 años,1990,4885,2400,2485
Nayarit,80 a 84 años,1995,5638,2708,2930
Nayarit,80 a 84 años,2000,9933,4981,4952
Nayarit,80 a 84 años,2005,11271,5622,5649
Nayarit,80 a 84 años,2010,13928,7002,6926
Nayarit,80 a 84 años,2020,13039,6345,6694
Nayarit,75 a 79 años,1990,7592,3808,3784
Nayarit,75 a 79 años,1995,8483,4274,4209
Nayarit,75 a 79 años,2000,13556,6913,6643
Nayarit,75 a 79 años,2005,15830,8126,7704
Nayarit,75 a 79 años,2010,21066,10519,10547
Nayarit,75 a 79 años,2020,19910,9792,10118
Nayarit,70 a 74 años,1990,10358,5268,5090
Nayarit,70 a 74 años,1995,12263,6325,5938
Nayarit,70 a 74 años,2000,18487,9317,9170
Nayarit,70 a 74 años,2005,21551,10898,10653
Nayarit,70 a 74 años,2010,25368,12694,12674
Nayarit,70 a 74 años,2020,27774,13560,14214
Nayarit,65 a 69 años,1990,13413,6789,6624
Nayarit,65 a 69 años,1995,16025,8081,7944
Nayarit,65 a 69 años,2000,23746,11964,11782
Nayarit,65 a 69 años,2005,27893,13971,13922
Nayarit,65 a 69 años,2010,32069,15866,16203
Nayarit,65 a 69 años,2020,37876,18563,19313
Nayarit,60 a 64 años,1990,17158,8686,8472
Nayarit,60 a 64 años,1995,20521,10438,10083
Nayarit,60 a 64 años,2000,27584,13924,13660
Nayarit,60 a 64 años,2005,31623,15747,15876
Nayarit,60 a 64 años,2010,39899,19693,20206
Nayarit,60 a 64 años,2020,47698,22763,24935
Nayarit,55 a 59 años,1990,20264,10438,9826
Nayarit,55 a 59 años,1995,24833,12653,12180
Nayarit,55 a 59 años,2000,33520,16820,16700
Nayarit,55 a 59 años,2005,39727,19578,20149
Nayarit,55 a 59 años,2010,48769,23609,25160
Nayarit,55 a 59 años,2020,54507,26262,28245
Nayarit,50 a 54 años,1990,25661,13038,12623
Nayarit,50 a 54 años,1995,29721,15068,14653
Nayarit,50 a 54 años,2000,40204,19711,20493
Nayarit,50 a 54 años,2005,47294,22809,24485
Nayarit,50 a 54 años,2010,55916,27147,28769
Nayarit,50 a 54 años,2020,64958,31691,33267
Nayarit,5 a 9 años,1990,109363,55506,53857
Nayarit,5 a 9 años,1995,110505,56418,54087
Nayarit,5 a 9 años,2000,100288,51107,49181
Nayarit,5 a 9 años,2005,92384,46895,45489
Nayarit,5 a 9 años,2010,106044,54138,51906
Nayarit,5 a 9 años,2020,113942,58000,55942
Nayarit,45 a 49 años,1990,30609,15426,15183
Nayarit,45 a 49 años,1995,35862,18025,17837
Nayarit,45 a 49 años,2000,49594,24008,25586
Nayarit,45 a 49 años,2005,54176,26110,28066
Nayarit,45 a 49 años,2010,64675,31810,32865
Nayarit,45 a 49 años,2020,75138,37298,37840
Nayarit,40 a 44 años,1990,34689,17253,17436
Nayarit,40 a 44 años,1995,43229,21563,21666
Nayarit,40 a 44 años,2000,57414,27608,29806
Nayarit,40 a 44 años,2005,62553,30053,32500
Nayarit,40 a 44 años,2010,78128,38953,39175
Nayarit,40 a 44 años,2020,81357,39971,41386
Nayarit,35 a 39 años,1990,44384,21711,22673
Nayarit,35 a 39 años,1995,53925,25900,28025
Nayarit,35 a 39 años,2000,62272,29734,32538
Nayarit,35 a 39 años,2005,69251,33146,36105
Nayarit,35 a 39 años,2010,79520,38922,40598
Nayarit,35 a 39 años,2020,85180,41559,43621
Nayarit,30 a 34 años,1990,49504,23882,25622
Nayarit,30 a 34 años,1995,58527,28236,30291
Nayarit,30 a 34 años,2000,72014,34447,37567
Nayarit,30 a 34 años,2005,69847,33028,36819
Nayarit,30 a 34 años,2010,82067,40065,42002
Nayarit,30 a 34 años,2020,90577,43990,46587
Nayarit,25 a 29 años,1990,56622,27020,29602
Nayarit,25 a 29 años,1995,66502,32220,34282
Nayarit,25 a 29 años,2000,81566,38786,42780
Nayarit,25 a 29 años,2005,79031,37566,41465
Nayarit,25 a 29 años,2010,96693,48059,48634
Nayarit,25 a 29 años,2020,92542,45237,47305
Nayarit,20 a 24 años,1990,70005,33394,36611
Nayarit,20 a 24 años,1995,86384,42502,43882
Nayarit,20 a 24 años,2000,97866,49021,48845
Nayarit,20 a 24 años,2005,97519,48922,48597
Nayarit,20 a 24 años,2010,107191,54204,52987
Nayarit,20 a 24 años,2020,97500,48537,48963
Nayarit,15 a 19 años,1990,99779,49847,49932
Nayarit,15 a 19 años,1995,102913,51622,51291
Nayarit,15 a 19 años,2000,107654,54737,52917
Nayarit,15 a 19 años,2005,103122,52426,50696
Nayarit,15 a 19 años,2010,104308,53367,50941
Nayarit,15 a 19 años,2020,104256,52792,51464
Nayarit,100 años y más,1990,252,112,140
Nayarit,100 años y más,1995,156,71,85
Nayarit,100 años y más,2000,680,316,364
Nayarit,100 años y más,2005,788,378,410
Nayarit,100 años y más,2010,799,368,431
Nayarit,100 años y más,2020,236,96,140
Nayarit,10 a 14 años,1990,112910,57093,55817
Nayarit,10 a 14 años,1995,110790,56474,54316
Nayarit,10 a 14 años,2000,107577,54727,52850
Nayarit,10 a 14 años,2005,96834,49627,47207
Nayarit,10 a 14 años,2010,104943,53253,51690
Nayarit,10 a 14 años,2020,113335,57726,55609
Nayarit,0 a 4 años,1990,103227,52490,50737
Nayarit,0 a 4 años,1995,103803,52853,50950
Nayarit,0 a 4 años,2000,920185,456105,464080
Nayarit,0 a 4 años,2005,949684,469204,480480
Nayarit,0 a 4 años,2010,1084979,541007,543972
Nayarit,0 a 4 años,2020,103601,52602,50999
Nuevo León,No especificado,1990,16593,8202,8391
Nuevo León,No especificado,1995,3557,1889,1668
Nuevo León,No especificado,2000,380,164,216
Nuevo León,No especificado,2005,376,143,233
Nuevo León,No especificado,2010,460,172,288
Nuevo León,No especificado,2020,18132,9049,9083
Nuevo León,95 a 99 años,1990,910,382,528
Nuevo León,95 a 99 años,1995,1256,538,718
Nuevo León,95 a 99 años,2000,4154,1677,2477
Nuevo León,95 a 99 años,2005,4738,1787,2951
Nuevo León,95 a 99 años,2010,5394,2066,3328
Nuevo León,95 a 99 años,2020,3097,1133,1964
Nuevo León,90 a 94 años,1990,2486,1061,1425
Nuevo León,90 a 94 años,1995,3497,1475,2022
Nuevo León,90 a 94 años,2000,10634,4424,6210
Nuevo León,90 a 94 años,2005,11929,5007,6922
Nuevo León,90 a 94 años,2010,16005,6629,9376
Nuevo León,90 a 94 años,2020,10365,3903,6462
Nuevo León,85 a 89 años,1990,7963,3447,4516
Nuevo León,85 a 89 años,1995,9406,4059,5347
Nuevo León,85 a 89 años,2000,17528,7667,9861
Nuevo León,85 a 89 años,2005,24628,10827,13801
Nuevo León,85 a 89 años,2010,30455,13075,17380
Nuevo León,85 a 89 años,2020,25023,10300,14723
Nuevo León,80 a 84 años,1990,14384,6381,8003
Nuevo León,80 a 84 años,1995,16178,7040,9138
Nuevo León,80 a 84 años,2000,33324,15550,17774
Nuevo León,80 a 84 años,2005,40397,18477,21920
Nuevo León,80 a 84 años,2010,48049,22136,25913
Nuevo León,80 a 84 años,2020,50350,22069,28281
Nuevo León,75 a 79 años,1990,23068,10578,12490
Nuevo León,75 a 79 años,1995,25120,11677,13443
Nuevo León,75 a 79 años,2000,48611,22607,26004
Nuevo León,75 a 79 años,2005,59373,27965,31408
Nuevo León,75 a 79 años,2010,75631,35695,39936
Nuevo León,75 a 79 años,2020,77327,35523,41804
Nuevo León,70 a 74 años,1990,29882,13885,15997
Nuevo León,70 a 74 años,1995,41030,19660,21370
Nuevo León,70 a 74 años,2000,65875,31411,34464
Nuevo León,70 a 74 años,2005,83083,39917,43166
Nuevo León,70 a 74 años,2010,96803,46293,50510
Nuevo León,70 a 74 años,2020,115822,53640,62182
Nuevo León,65 a 69 años,1990,46095,22190,23905
Nuevo León,65 a 69 años,1995,57318,27042,30276
Nuevo León,65 a 69 años,2000,92626,44938,47688
Nuevo León,65 a 69 años,2005,108646,52394,56252
Nuevo León,65 a 69 años,2010,132607,63516,69091
Nuevo León,65 a 69 años,2020,154408,72766,81642
Nuevo León,60 a 64 años,1990,62398,29546,32852
Nuevo León,60 a 64 años,1995,77359,37553,39806
Nuevo León,60 a 64 años,2000,109729,53878,55851
Nuevo León,60 a 64 años,2005,134046,65124,68922
Nuevo León,60 a 64 años,2010,162140,78944,83196
Nuevo León,60 a 64 años,2020,217238,103697,113541
Nuevo León,55 a 59 años,1990,75104,36957,38147
Nuevo León,55 a 59 años,1995,96263,47706,48557
Nuevo León,55 a 59 años,2000,144499,70886,73613
Nuevo León,55 a 59 años,2005,172436,83952,88484
Nuevo León,55 a 59 años,2010,220801,107080,113721
Nuevo León,55 a 59 años,2020,260045,126971,133074
Nuevo León,50 a 54 años,1990,100263,49598,50665
Nuevo León,50 a 54 años,1995,122905,60893,62012
Nuevo León,50 a 54 años,2000,168680,82616,86064
Nuevo León,50 a 54 años,2005,218683,106900,111783
Nuevo León,50 a 54 años,2010,260606,128429,132177
Nuevo León,50 a 54 años,2020,334439,164492,169947
Nuevo León,5 a 9 años,1990,350558,178254,172304
Nuevo León,5 a 9 años,1995,360813,183897,176916
Nuevo León,5 a 9 años,2000,396563,201948,194615
Nuevo León,5 a 9 años,2005,396832,202457,194375
Nuevo León,5 a 9 años,2010,413360,210075,203285
Nuevo León,5 a 9 años,2020,463819,235679,228140
Nuevo León,45 a 49 años,1990,121838,60748,61090
Nuevo León,45 a 49 años,1995,151856,75209,76647
Nuevo León,45 a 49 años,2000,224330,110097,114233
Nuevo León,45 a 49 años,2005,265277,131231,134046
Nuevo León,45 a 49 años,2010,321008,159078,161930
Nuevo León,45 a 49 años,2020,387678,194154,193524
Nuevo León,40 a 44 años,1990,145262,71411,73851
Nuevo León,40 a 44 años,1995,183087,90621,92466
Nuevo León,40 a 44 años,2000,272200,134659,137541
Nuevo León,40 a 44 años,2005,322812,159879,162933
Nuevo León,40 a 44 años,2010,383357,191768,191589
Nuevo León,40 a 44 años,2020,409490,204944,204546
Nuevo León,35 a 39 años,1990,180402,88772,91630
Nuevo León,35 a 39 años,1995,243192,120187,123005
Nuevo León,35 a 39 años,2000,322572,158942,163630
Nuevo León,35 a 39 años,2005,368549,183158,185391
Nuevo León,35 a 39 años,2010,383736,191204,192532
Nuevo León,35 a 39 años,2020,426619,215999,210620
Nuevo León,30 a 34 años,1990,226879,110900,115979
Nuevo León,30 a 34 años,1995,283907,140426,143481
Nuevo León,30 a 34 años,2000,369135,183270,185865
Nuevo León,30 a 34 años,2005,364392,181145,183247
Nuevo León,30 a 34 años,2010,384086,192963,191123
Nuevo León,30 a 34 años,2020,448470,227051,221419
Nuevo León,25 a 29 años,1990,267335,131768,135567
Nuevo León,25 a 29 años,1995,336502,166536,169966
Nuevo León,25 a 29 años,2000,391235,195585,195650
Nuevo León,25 a 29 años,2005,381072,191558,189514
Nuevo León,25 a 29 años,2010,401723,202766,198957
Nuevo León,25 a 29 años,2020,488349,248479,239870
Nuevo León,20 a 24 años,1990,337524,168514,169010
Nuevo León,20 a 24 años,1995,412575,207929,204646
Nuevo León,20 a 24 años,2000,373807,187079,186728
Nuevo León,20 a 24 años,2005,372986,187600,185386
Nuevo León,20 a 24 años,2010,406428,205518,200910
Nuevo León,20 a 24 años,2020,503826,255533,248293
Nuevo León,15 a 19 años,1990,388480,195037,193443
Nuevo León,15 a 19 años,1995,390485,195644,194841
Nuevo León,15 a 19 años,2000,355194,180250,174944
Nuevo León,15 a 19 años,2005,381498,193885,187613
Nuevo León,15 a 19 años,2010,415368,211365,204003
Nuevo León,15 a 19 años,2020,471896,240241,231655
Nuevo León,100 años y más,1990,334,108,226
Nuevo León,100 años y más,1995,267,96,171
Nuevo León,100 años y más,2000,1741,664,1077
Nuevo León,100 años y más,2005,1817,709,1108
Nuevo León,100 años y más,2010,1874,695,1179
Nuevo León,100 años y más,2020,420,116,304
Nuevo León,10 a 14 años,1990,369459,186328,183131
Nuevo León,10 a 14 años,1995,360951,183492,177459
Nuevo León,10 a 14 años,2000,385771,196456,189315
Nuevo León,10 a 14 años,2005,403641,205432,198209
Nuevo León,10 a 14 años,2010,430525,219102,211423
Nuevo León,10 a 14 años,2020,462720,235404,227316
Nuevo León,0 a 4 años,1990,331519,168597,162922
Nuevo León,0 a 4 años,1995,372590,190224,182366
Nuevo León,0 a 4 años,2000,3834141,1907939,1926202
Nuevo León,0 a 4 años,2005,4199292,2090673,2108619
Nuevo León,0 a 4 años,2010,4653458,2320185,2333273
Nuevo León,0 a 4 años,2020,454909,229807,225102
Oaxaca,No especificado,1990,6340,3022,3318
Oaxaca,No especificado,1995,14723,6561,8162
Oaxaca,No especificado,2000,1013,421,592
Oaxaca,No especificado,2005,992,365,627
Oaxaca,No especificado,2010,1047,407,640
Oaxaca,No especificado,2020,9388,4668,4720
Oaxaca,95 a 99 años,1990,1879,732,1147
Oaxaca,95 a 99 años,1995,2299,976,1323
Oaxaca,95 a 99 años,2000,5243,2301,2942
Oaxaca,95 a 99 años,2005,5751,2498,3253
Oaxaca,95 a 99 años,2010,7840,3481,4359
Oaxaca,95 a 99 años,2020,4898,2080,2818
Oaxaca,90 a 94 años,1990,4323,1849,2474
Oaxaca,90 a 94 años,1995,4457,1928,2529
Oaxaca,90 a 94 años,2000,12144,5476,6668
Oaxaca,90 a 94 años,2005,15726,7149,8577
Oaxaca,90 a 94 años,2010,21170,9631,11539
Oaxaca,90 a 94 años,2020,12630,5550,7080
Oaxaca,85 a 89 años,1990,9700,4452,5248
Oaxaca,85 a 89 años,1995,9835,4628,5207
Oaxaca,85 a 89 años,2000,22243,10161,12082
Oaxaca,85 a 89 años,2005,29144,13547,15597
Oaxaca,85 a 89 años,2010,35768,16415,19353
Oaxaca,85 a 89 años,2020,31435,14216,17219
Oaxaca,80 a 84 años,1990,17595,7929,9666
Oaxaca,80 a 84 años,1995,18426,8419,10007
Oaxaca,80 a 84 años,2000,36889,17946,18943
Oaxaca,80 a 84 años,2005,44826,21403,23423
Oaxaca,80 a 84 años,2010,55599,26055,29544
Oaxaca,80 a 84 años,2020,50714,23170,27544
Oaxaca,75 a 79 años,1990,24056,11640,12416
Oaxaca,75 a 79 años,1995,28012,13617,14395
Oaxaca,75 a 79 años,2000,52015,25100,26915
Oaxaca,75 a 79 años,2005,61759,29226,32533
Oaxaca,75 a 79 años,2010,80884,37246,43638
Oaxaca,75 a 79 años,2020,73118,34298,38820
Oaxaca,70 a 74 años,1990,35881,17231,18650
Oaxaca,70 a 74 años,1995,43471,21251,22220
Oaxaca,70 a 74 años,2000,68801,32165,36636
Oaxaca,70 a 74 años,2005,77317,35777,41540
Oaxaca,70 a 74 años,2010,90363,41593,48770
Oaxaca,70 a 74 años,2020,93692,43728,49964
Oaxaca,65 a 69 años,1990,48631,23567,25064
Oaxaca,65 a 69 años,1995,55762,26632,29130
Oaxaca,65 a 69 años,2000,89096,42185,46911
Oaxaca,65 a 69 años,2005,102856,47633,55223
Oaxaca,65 a 69 años,2010,110092,51536,58556
Oaxaca,65 a 69 años,2020,127194,58872,68322
Oaxaca,60 a 64 años,1990,68702,33329,35373
Oaxaca,60 a 64 años,1995,78424,37683,40741
Oaxaca,60 a 64 años,2000,96806,45487,51319
Oaxaca,60 a 64 años,2005,107316,50555,56761
Oaxaca,60 a 64 años,2010,134078,63189,70889
Oaxaca,60 a 64 años,2020,155780,72135,83645
Oaxaca,55 a 59 años,1990,77251,37064,40187
Oaxaca,55 a 59 años,1995,83816,39984,43832
Oaxaca,55 a 59 años,2000,116999,55337,61662
Oaxaca,55 a 59 años,2005,136431,64181,72250
Oaxaca,55 a 59 años,2010,163536,75664,87872
Oaxaca,55 a 59 años,2020,179408,83007,96401
Oaxaca,50 a 54 años,1990,93382,44627,48755
Oaxaca,50 a 54 años,1995,103778,49639,54139
Oaxaca,50 a 54 años,2000,139877,65800,74077
Oaxaca,50 a 54 años,2005,161350,74758,86592
Oaxaca,50 a 54 años,2010,187021,86487,100534
Oaxaca,50 a 54 años,2020,210438,96862,113576
Oaxaca,5 a 9 años,1990,452387,228078,224309
Oaxaca,5 a 9 años,1995,436486,220830,215656
Oaxaca,5 a 9 años,2000,395993,200413,195580
Oaxaca,5 a 9 años,2005,357272,180883,176389
Oaxaca,5 a 9 años,2010,373371,189157,184214
Oaxaca,5 a 9 años,2020,388759,195501,193258
Oaxaca,45 a 49 años,1990,114456,54594,59862
Oaxaca,45 a 49 años,1995,123361,58894,64467
Oaxaca,45 a 49 años,2000,167187,78342,88845
Oaxaca,45 a 49 años,2005,185440,86072,99368
Oaxaca,45 a 49 años,2010,208666,96524,112142
Oaxaca,45 a 49 años,2020,233971,108738,125233
Oaxaca,40 a 44 años,1990,122750,58580,64170
Oaxaca,40 a 44 años,1995,143539,69431,74108
Oaxaca,40 a 44 años,2000,199131,92160,106971
Oaxaca,40 a 44 años,2005,210256,95780,114476
Oaxaca,40 a 44 años,2010,244019,112008,132011
Oaxaca,40 a 44 años,2020,259478,120384,139094
Oaxaca,35 a 39 años,1990,158367,74828,83539
Oaxaca,35 a 39 años,1995,183926,86730,97196
Oaxaca,35 a 39 años,2000,213839,98179,115660
Oaxaca,35 a 39 años,2005,230648,104049,126599
Oaxaca,35 a 39 años,2010,259112,117774,141338
Oaxaca,35 a 39 años,2020,276496,127897,148599
Oaxaca,30 a 34 años,1990,174609,82811,91798
Oaxaca,30 a 34 años,1995,198336,94093,104243
Oaxaca,30 a 34 años,2000,239657,109330,130327
Oaxaca,30 a 34 años,2005,243386,108120,135266
Oaxaca,30 a 34 años,2010,268969,122545,146424
Oaxaca,30 a 34 años,2020,289279,132924,156355
Oaxaca,25 a 29 años,1990,205136,95962,109174
Oaxaca,25 a 29 años,1995,223026,104693,118333
Oaxaca,25 a 29 años,2000,288035,130967,157068
Oaxaca,25 a 29 años,2005,281999,127254,154745
Oaxaca,25 a 29 años,2010,313523,145055,168468
Oaxaca,25 a 29 años,2020,307124,141381,165743
Oaxaca,20 a 24 años,1990,245537,115625,129912
Oaxaca,20 a 24 años,1995,281574,133575,147999
Oaxaca,20 a 24 años,2000,364876,177322,187554
Oaxaca,20 a 24 años,2005,366868,178035,188833
Oaxaca,20 a 24 años,2010,406873,200381,206492
Oaxaca,20 a 24 años,2020,310307,147137,163170
Oaxaca,15 a 19 años,1990,324057,159459,164598
Oaxaca,15 a 19 años,1995,358526,178098,180428
Oaxaca,15 a 19 años,2000,443874,224737,219137
Oaxaca,15 a 19 años,2005,443980,223625,220355
Oaxaca,15 a 19 años,2010,414392,209447,204945
Oaxaca,15 a 19 años,2020,358708,178973,179735
Oaxaca,100 años y más,1990,1070,433,637
Oaxaca,100 años y más,1995,731,291,440
Oaxaca,100 años y más,2000,2871,1176,1695
Oaxaca,100 años y más,2005,2870,1217,1653
Oaxaca,100 años y más,2010,3406,1401,2005
Oaxaca,100 años y más,2020,1116,433,683
Oaxaca,10 a 14 años,1990,422710,214416,208294
Oaxaca,10 a 14 años,1995,434282,220899,213383
Oaxaca,10 a 14 años,2000,458507,230819,227688
Oaxaca,10 a 14 años,2005,394779,199744,195035
Oaxaca,10 a 14 años,2010,399632,201833,197799
Oaxaca,10 a 14 años,2020,398362,201586,196776
Oaxaca,0 a 4 años,1990,410741,207210,203531
Oaxaca,0 a 4 años,1995,402105,203558,198547
Oaxaca,0 a 4 años,2000,3438765,1657406,1781359
Oaxaca,0 a 4 años,2005,3506821,1674855,1831966
Oaxaca,0 a 4 años,2010,3801962,1819008,1982954
Oaxaca,0 a 4 años,2020,359853,181303,178550
Puebla,No especificado,1990,10712,5103,5609
Puebla,No especificado,1995,5331,2410,2921
Puebla,No especificado,2000,1288,421,867
Puebla,No especificado,2005,1187,373,814
Puebla,No especificado,2010,1057,329,728
Puebla,No especificado,2020,5671,2822,2849
Puebla,95 a 99 años,1990,2545,950,1595
Puebla,95 a 99 años,1995,3474,1354,2120
Puebla,95 a 99 años,2000,7044,2835,4209
Puebla,95 a 99 años,2005,7209,2908,4301
Puebla,95 a 99 años,2010,9528,3906,5622
Puebla,95 a 99 años,2020,5631,2077,3554
Puebla,90 a 94 años,1990,5691,2258,3433
Puebla,90 a 94 años,1995,6218,2547,3671
Puebla,90 a 94 años,2000,16421,6957,9464
Puebla,90 a 94 años,2005,20730,8886,11844
Puebla,90 a 94 años,2010,26380,11168,15212
Puebla,90 a 94 años,2020,14770,5903,8867
Puebla,85 a 89 años,1990,13525,5853,7672
Puebla,85 a 89 años,1995,14447,6285,8162
Puebla,85 a 89 años,2000,27369,12137,15232
Puebla,85 a 89 años,2005,36177,16005,20172
Puebla,85 a 89 años,2010,43367,18969,24398
Puebla,85 a 89 años,2020,36491,15340,21151
Puebla,80 a 84 años,1990,22198,9781,12417
Puebla,80 a 84 años,1995,22993,9964,13029
Puebla,80 a 84 años,2000,48685,22735,25950
Puebla,80 a 84 años,2005,58514,26859,31655
Puebla,80 a 84 años,2010,67019,30238,36781
Puebla,80 a 84 años,2020,60354,26102,34252
Puebla,75 a 79 años,1990,31992,14971,17021
Puebla,75 a 79 años,1995,38212,18186,20026
Puebla,75 a 79 años,2000,67351,31233,36118
Puebla,75 a 79 años,2005,78396,35821,42575
Puebla,75 a 79 años,2010,96685,43408,53277
Puebla,75 a 79 años,2020,91494,41799,49695
Puebla,70 a 74 años,1990,45259,21277,23982
Puebla,70 a 74 años,1995,57670,27227,30443
Puebla,70 a 74 años,2000,89492,40477,49015
Puebla,70 a 74 años,2005,100862,46020,54842
Puebla,70 a 74 años,2010,115990,53384,62606
Puebla,70 a 74 años,2020,128374,58004,70370
Puebla,65 a 69 años,1990,63979,30069,33910
Puebla,65 a 69 años,1995,76919,35373,41546
Puebla,65 a 69 años,2000,111996,51913,60083
Puebla,65 a 69 años,2005,133552,61586,71966
Puebla,65 a 69 años,2010,150565,69041,81524
Puebla,65 a 69 años,2020,177876,80892,96984
Puebla,60 a 64 años,1990,85006,40083,44923
Puebla,60 a 64 años,1995,100868,47280,53588
Puebla,60 a 64 años,2000,127639,59810,67829
Puebla,60 a 64 años,2005,154041,71906,82135
Puebla,60 a 64 años,2010,188919,88207,100712
Puebla,60 a 64 años,2020,229364,104369,124995
Puebla,55 a 59 años,1990,99683,47017,52666
Puebla,55 a 59 años,1995,113605,53333,60272
Puebla,55 a 59 años,2000,162662,76667,85995
Puebla,55 a 59 años,2005,197862,92385,105477
Puebla,55 a 59 años,2010,240020,110377,129643
Puebla,55 a 59 años,2020,269080,123605,145475
Puebla,50 a 54 años,1990,118670,56107,62563
Puebla,50 a 54 años,1995,139750,66956,72794
Puebla,50 a 54 años,2000,197500,92631,104869
Puebla,50 a 54 años,2005,242420,112766,129654
Puebla,50 a 54 años,2010,279425,129308,150117
Puebla,50 a 54 años,2020,334597,153039,181558
Puebla,5 a 9 años,1990,587427,295554,291873
Puebla,5 a 9 años,1995,594003,300772,293231
Puebla,5 a 9 años,2000,578641,293332,285309
Puebla,5 a 9 años,2005,579804,293977,285827
Puebla,5 a 9 años,2010,574513,291584,282929
Puebla,5 a 9 años,2020,598550,302188,296362
Puebla,45 a 49 años,1990,148058,70806,77252
Puebla,45 a 49 años,1995,175518,83337,92181
Puebla,45 a 49 años,2000,243578,114420,129158
Puebla,45 a 49 años,2005,283374,132012,151362
Puebla,45 a 49 años,2010,328556,151228,177328
Puebla,45 a 49 años,2020,382865,178206,204659
Puebla,40 a 44 años,1990,166092,79353,86739
Puebla,40 a 44 años,1995,207950,100039,107911
Puebla,40 a 44 años,2000,297693,138467,159226
Puebla,40 a 44 años,2005,340799,156674,184125
Puebla,40 a 44 años,2010,394961,182690,212271
Puebla,40 a 44 años,2020,425089,196550,228539
Puebla,35 a 39 años,1990,220557,104236,116321
Puebla,35 a 39 años,1995,275167,129853,145314
Puebla,35 a 39 años,2000,332646,153434,179212
Puebla,35 a 39 años,2005,384349,176534,207815
Puebla,35 a 39 años,2010,420492,192949,227543
Puebla,35 a 39 años,2020,457864,212520,245344
Puebla,30 a 34 años,1990,250317,118110,132207
Puebla,30 a 34 años,1995,299213,140849,158364
Puebla,30 a 34 años,2000,384326,178237,206089
Puebla,30 a 34 años,2005,411939,187990,223949
Puebla,30 a 34 años,2010,441558,203626,237932
Puebla,30 a 34 años,2020,475854,221145,254709
Puebla,25 a 29 años,1990,295479,138847,156632
Puebla,25 a 29 años,1995,351785,165411,186374
Puebla,25 a 29 años,2000,460965,214250,246715
Puebla,25 a 29 años,2005,474429,217540,256889
Puebla,25 a 29 años,2010,511685,241187,270498
Puebla,25 a 29 años,2020,528289,251899,276390
Puebla,20 a 24 años,1990,369823,174448,195375
Puebla,20 a 24 años,1995,447281,212862,234419
Puebla,20 a 24 años,2000,532196,258724,273472
Puebla,20 a 24 años,2005,548971,268014,280957
Puebla,20 a 24 años,2010,604094,299098,304996
Puebla,20 a 24 años,2020,570646,279374,291272
Puebla,15 a 19 años,1990,471300,231159,240141
Puebla,15 a 19 años,1995,526378,259523,266855
Puebla,15 a 19 años,2000,600452,303571,296881
Puebla,15 a 19 años,2005,624075,314797,309278
Puebla,15 a 19 años,2010,604845,305657,299188
Puebla,15 a 19 años,2020,607200,305827,301373
Puebla,100 años y más,1990,1338,436,902
Puebla,100 años y más,1995,1010,311,699
Puebla,100 años y más,2000,4142,1559,2583
Puebla,100 años y más,2005,3919,1408,2511
Puebla,100 años y más,2010,3845,1413,2432
Puebla,100 años y más,2020,1065,335,730
Puebla,10 a 14 años,1990,566985,284925,282060
Puebla,10 a 14 años,1995,591644,299025,292619
Puebla,10 a 14 años,2000,623917,314710,309207
Puebla,10 a 14 años,2005,586108,297066,289042
Puebla,10 a 14 años,2010,620386,314122,306264
Puebla,10 a 14 años,2020,603375,305853,297522
Puebla,0 a 4 años,1990,549465,277188,272277
Puebla,0 a 4 años,1995,574929,290579,284350
Puebla,0 a 4 años,2000,5076686,2448801,2627885
Puebla,0 a 4 años,2005,5383133,2578664,2804469
Puebla,0 a 4 años,2010,5779829,2769855,3009974
Puebla,0 a 4 años,2020,578779,292266,286513
Querétaro,No especificado,1990,6857,3330,3527
Querétaro,No especificado,1995,2815,1329,1486
Querétaro,No especificado,2000,231,93,138
Querétaro,No especificado,2005,184,65,119
Querétaro,No especificado,2010,207,70,137
Querétaro,No especificado,2020,6824,3400,3424
Querétaro,95 a 99 años,1990,486,186,300
Querétaro,95 a 99 años,1995,639,255,384
Querétaro,95 a 99 años,2000,1683,660,1023
Querétaro,95 a 99 años,2005,1700,641,1059
Querétaro,95 a 99 años,2010,2344,914,1430
Querétaro,95 a 99 años,2020,1531,557,974
Querétaro,90 a 94 años,1990,1199,492,707
Querétaro,90 a 94 años,1995,1288,562,726
Querétaro,90 a 94 años,2000,3719,1523,2196
Querétaro,90 a 94 años,2005,4475,1851,2624
Querétaro,90 a 94 años,2010,6400,2751,3649
Querétaro,90 a 94 años,2020,4195,1596,2599
Querétaro,85 a 89 años,1990,2880,1297,1583
Querétaro,85 a 89 años,1995,3162,1399,1763
Querétaro,85 a 89 años,2000,5795,2522,3273
Querétaro,85 a 89 años,2005,8367,3739,4628
Querétaro,85 a 89 años,2010,10760,4641,6119
Querétaro,85 a 89 años,2020,9975,4174,5801
Querétaro,80 a 84 años,1990,4961,2151,2810
Querétaro,80 a 84 años,1995,5166,2238,2928
Querétaro,80 a 84 años,2000,10678,5062,5616
Querétaro,80 a 84 años,2005,13166,6057,7109
Querétaro,80 a 84 años,2010,16494,7562,8932
Querétaro,80 a 84 años,2020,17321,7578,9743
Querétaro,75 a 79 años,1990,6927,3161,3766
Querétaro,75 a 79 años,1995,7532,3497,4035
Querétaro,75 a 79 años,2000,15069,7071,7998
Querétaro,75 a 79 años,2005,18292,8548,9744
Querétaro,75 a 79 años,2010,24701,11421,13280
Querétaro,75 a 79 años,2020,27417,12516,14901
Querétaro,70 a 74 años,1990,8951,4190,4761
Querétaro,70 a 74 años,1995,12377,5987,6390
Querétaro,70 a 74 años,2000,19724,9247,10477
Querétaro,70 a 74 años,2005,24520,11554,12966
Querétaro,70 a 74 años,2010,31562,14757,16805
Querétaro,70 a 74 años,2020,40979,18799,22180
Querétaro,65 a 69 años,1990,13200,6350,6850
Querétaro,65 a 69 años,1995,15847,7473,8374
Querétaro,65 a 69 años,2000,25807,12175,13632
Querétaro,65 a 69 años,2005,33692,15806,17886
Querétaro,65 a 69 años,2010,42991,20110,22881
Querétaro,65 a 69 años,2020,57833,26736,31097
Querétaro,60 a 64 años,1990,17638,8451,9187
Querétaro,60 a 64 años,1995,21951,10393,11558
Querétaro,60 a 64 años,2000,31402,15160,16242
Querétaro,60 a 64 años,2005,40621,19600,21021
Querétaro,60 a 64 años,2010,56288,26912,29376
Querétaro,60 a 64 años,2020,80729,37769,42960
Querétaro,55 a 59 años,1990,21099,10276,10823
Querétaro,55 a 59 años,1995,25227,12280,12947
Querétaro,55 a 59 años,2000,41725,20337,21388
Querétaro,55 a 59 años,2005,57129,27531,29598
Querétaro,55 a 59 años,2010,76870,36628,40242
Querétaro,55 a 59 años,2020,97903,46132,51771
Querétaro,50 a 54 años,1990,25959,12636,13323
Querétaro,50 a 54 años,1995,33922,16851,17071
Querétaro,50 a 54 años,2000,53778,26143,27635
Querétaro,50 a 54 años,2005,73238,35138,38100
Querétaro,50 a 54 años,2010,93449,44472,48977
Querétaro,50 a 54 años,2020,125857,59009,66848
Querétaro,5 a 9 años,1990,149342,75103,74239
Querétaro,5 a 9 años,1995,159715,80724,78991
Querétaro,5 a 9 años,2000,163581,83110,80471
Querétaro,5 a 9 años,2005,162841,82781,80060
Querétaro,5 a 9 años,2010,178916,90972,87944
Querétaro,5 a 9 años,2020,196969,99958,97011
Querétaro,45 a 49 años,1990,33968,16788,17180
Querétaro,45 a 49 años,1995,43552,21587,21965
Querétaro,45 a 49 años,2000,72087,34784,37303
Querétaro,45 a 49 años,2005,91576,43747,47829
Querétaro,45 a 49 años,2010,114275,53763,60512
Querétaro,45 a 49 años,2020,149832,71841,77991
Querétaro,40 a 44 años,1990,40378,19975,20403
Querétaro,40 a 44 años,1995,56445,28124,28321
Querétaro,40 a 44 años,2000,90271,43023,47248
Querétaro,40 a 44 años,2005,109689,51435,58254
Querétaro,40 a 44 años,2010,138438,65728,72710
Querétaro,40 a 44 años,2020,165728,79318,86410
Querétaro,35 a 39 años,1990,55252,27222,28030
Querétaro,35 a 39 años,1995,77155,37633,39522
Querétaro,35 a 39 años,2000,103722,48193,55529
Querétaro,35 a 39 años,2005,126438,59116,67322
Querétaro,35 a 39 años,2010,145169,68081,77088
Querétaro,35 a 39 años,2020,182743,87967,94776
Querétaro,30 a 34 años,1990,67780,32945,34835
Querétaro,30 a 34 años,1995,89066,42868,46198
Querétaro,30 a 34 años,2000,119099,55547,63552
Querétaro,30 a 34 años,2005,130500,60021,70479
Querétaro,30 a 34 años,2010,153300,72317,80983
Querétaro,30 a 34 años,2020,194576,94293,100283
Querétaro,25 a 29 años,1990,81606,38944,42662
Querétaro,25 a 29 años,1995,103287,49042,54245
Querétaro,25 a 29 años,2000,136899,63403,73496
Querétaro,25 a 29 años,2005,146713,68013,78700
Querétaro,25 a 29 años,2010,168520,80717,87803
Querétaro,25 a 29 años,2020,214139,105543,108596
Querétaro,20 a 24 años,1990,100487,47269,53218
Querétaro,20 a 24 años,1995,130819,62591,68228
Querétaro,20 a 24 años,2000,152906,73825,79081
Querétaro,20 a 24 años,2005,162541,79047,83494
Querétaro,20 a 24 años,2010,187241,92904,94337
Querétaro,20 a 24 años,2020,209039,104347,104692
Querétaro,15 a 19 años,1990,125235,61191,64044
Querétaro,15 a 19 años,1995,145338,71349,73989
Querétaro,15 a 19 años,2000,164074,82482,81592
Querétaro,15 a 19 años,2005,178589,89895,88694
Querétaro,15 a 19 años,2010,182608,92453,90155
Querétaro,15 a 19 años,2020,198141,99841,98300
Querétaro,100 años y más,1990,187,62,125
Querétaro,100 años y más,1995,140,46,94
Querétaro,100 años y más,2000,868,351,517
Querétaro,100 años y más,2005,840,315,525
Querétaro,100 años y más,2010,922,303,619
Querétaro,100 años y más,2020,242,76,166
Querétaro,10 a 14 años,1990,140664,70380,70284
Querétaro,10 a 14 años,1995,155971,78843,77128
Querétaro,10 a 14 años,2000,174551,87912,86639
Querétaro,10 a 14 años,2005,168900,85804,83096
Querétaro,10 a 14 años,2010,183541,93230,90311
Querétaro,10 a 14 años,2020,198601,100847,97754
Querétaro,0 a 4 años,1990,146179,73769,72410
Querétaro,0 a 4 años,1995,159062,80413,78649
Querétaro,0 a 4 años,2000,1404306,680966,723340
Querétaro,0 a 4 años,2005,1598139,772759,825380
Querétaro,0 a 4 años,2010,1827937,887188,940749
Querétaro,0 a 4 años,2020,187893,94523,93370
Quintana Roo,No especificado,1990,9312,4796,4516
Quintana Roo,No especificado,1995,1721,923,798
Quintana Roo,No especificado,2000,109,63,46
Quintana Roo,No especificado,2005,70,46,24
Quintana Roo,No especificado,2010,76,43,33
Quintana Roo,No especificado,2020,21022,10501,10521
Quintana Roo,95 a 99 años,1990,111,50,61
Quintana Roo,95 a 99 años,1995,142,70,72
Quintana Roo,95 a 99 años,2000,361,188,173
Quintana Roo,95 a 99 años,2005,477,248,229
Quintana Roo,95 a 99 años,2010,761,387,374
Quintana Roo,95 a 99 años,2020,531,253,278
Quintana Roo,90 a 94 años,1990,233,134,99
Quintana Roo,90 a 94 años,1995,303,158,145
Quintana Roo,90 a 94 años,2000,1006,537,469
Quintana Roo,90 a 94 años,2005,1499,754,745
Quintana Roo,90 a 94 años,2010,2070,1048,1022
Quintana Roo,90 a 94 años,2020,1332,564,768
Quintana Roo,85 a 89 años,1990,477,254,223
Quintana Roo,85 a 89 años,1995,710,408,302
Quintana Roo,85 a 89 años,2000,1984,1076,908
Quintana Roo,85 a 89 años,2005,2770,1457,1313
Quintana Roo,85 a 89 años,2010,3639,1831,1808
Quintana Roo,85 a 89 años,2020,3775,1729,2046
Quintana Roo,80 a 84 años,1990,978,569,409
Quintana Roo,80 a 84 años,1995,1392,791,601
Quintana Roo,80 a 84 años,2000,3641,2027,1614
Quintana Roo,80 a 84 años,2005,4657,2454,2203
Quintana Roo,80 a 84 años,2010,6453,3276,3177
Quintana Roo,80 a 84 años,2020,7421,3570,3851
Quintana Roo,75 a 79 años,1990,1607,888,719
Quintana Roo,75 a 79 años,1995,2473,1403,1070
Quintana Roo,75 a 79 años,2000,5226,2819,2407
Quintana Roo,75 a 79 años,2005,7226,3713,3513
Quintana Roo,75 a 79 años,2010,10761,5469,5292
Quintana Roo,75 a 79 años,2020,12688,6268,6420
Quintana Roo,70 a 74 años,1990,2724,1567,1157
Quintana Roo,70 a 74 años,1995,4227,2391,1836
Quintana Roo,70 a 74 años,2000,7861,4015,3846
Quintana Roo,70 a 74 años,2005,10845,5559,5286
Quintana Roo,70 a 74 años,2010,15430,7924,7506
Quintana Roo,70 a 74 años,2020,21678,10704,10974
Quintana Roo,65 a 69 años,1990,3980,2228,1752
Quintana Roo,65 a 69 años,1995,5655,3053,2602
Quintana Roo,65 a 69 años,2000,11995,6274,5721
Quintana Roo,65 a 69 años,2005,16414,8388,8026
Quintana Roo,65 a 69 años,2010,24478,12373,12105
Quintana Roo,65 a 69 años,2020,34204,16738,17466
Quintana Roo,60 a 64 años,1990,5735,3220,2515
Quintana Roo,60 a 64 años,1995,8972,4747,4225
Quintana Roo,60 a 64 años,2000,15498,8164,7334
Quintana Roo,60 a 64 años,2005,23000,11898,11102
Quintana Roo,60 a 64 años,2010,34052,17591,16461
Quintana Roo,60 a 64 años,2020,49321,24175,25146
Quintana Roo,55 a 59 años,1990,7518,4017,3501
Quintana Roo,55 a 59 años,1995,11398,6034,5364
Quintana Roo,55 a 59 años,2000,23169,12359,10810
Quintana Roo,55 a 59 años,2005,32692,16898,15794
Quintana Roo,55 a 59 años,2010,48629,24865,23764
Quintana Roo,55 a 59 años,2020,66985,33514,33471
Quintana Roo,50 a 54 años,1990,10415,5665,4750
Quintana Roo,50 a 54 años,1995,16174,8719,7455
Quintana Roo,50 a 54 años,2000,31473,16553,14920
Quintana Roo,50 a 54 años,2005,43595,22306,21289
Quintana Roo,50 a 54 años,2010,64630,33236,31394
Quintana Roo,50 a 54 años,2020,94160,47616,46544
Quintana Roo,5 a 9 años,1990,66069,33610,32459
Quintana Roo,5 a 9 años,1995,87369,44445,42924
Quintana Roo,5 a 9 años,2000,105575,54075,51500
Quintana Roo,5 a 9 años,2005,107380,54437,52943
Quintana Roo,5 a 9 años,2010,133228,67703,65525
Quintana Roo,5 a 9 años,2020,155388,78621,76767
Quintana Roo,45 a 49 años,1990,14626,8007,6619
Quintana Roo,45 a 49 años,1995,23400,12479,10921
Quintana Roo,45 a 49 años,2000,43641,22769,20872
Quintana Roo,45 a 49 años,2005,59687,30565,29122
Quintana Roo,45 a 49 años,2010,86941,44886,42055
Quintana Roo,45 a 49 años,2020,117045,59554,57491
Quintana Roo,40 a 44 años,1990,19006,10413,8593
Quintana Roo,40 a 44 años,1995,31617,16799,14818
Quintana Roo,40 a 44 años,2000,61416,31674,29742
Quintana Roo,40 a 44 años,2005,78570,39966,38604
Quintana Roo,40 a 44 años,2010,111169,56596,54573
Quintana Roo,40 a 44 años,2020,136731,68835,67896
Quintana Roo,35 a 39 años,1990,28267,14845,13422
Quintana Roo,35 a 39 años,1995,45621,23653,21968
Quintana Roo,35 a 39 años,2000,77734,39932,37802
Quintana Roo,35 a 39 años,2005,93113,46621,46492
Quintana Roo,35 a 39 años,2010,120654,60588,60066
Quintana Roo,35 a 39 años,2020,161472,81665,79807
Quintana Roo,30 a 34 años,1990,35950,18643,17307
Quintana Roo,30 a 34 años,1995,58722,30204,28518
Quintana Roo,30 a 34 años,2000,90750,45804,44946
Quintana Roo,30 a 34 años,2005,97203,48401,48802
Quintana Roo,30 a 34 años,2010,130616,65694,64922
Quintana Roo,30 a 34 años,2020,175133,88048,87085
Quintana Roo,25 a 29 años,1990,46170,23617,22553
Quintana Roo,25 a 29 años,1995,72421,37052,35369
Quintana Roo,25 a 29 años,2000,94752,47989,46763
Quintana Roo,25 a 29 años,2005,103377,52041,51336
Quintana Roo,25 a 29 años,2010,135549,68519,67030
Quintana Roo,25 a 29 años,2020,184447,93034,91413
Quintana Roo,20 a 24 años,1990,54226,27810,26416
Quintana Roo,20 a 24 años,1995,81267,41218,40049
Quintana Roo,20 a 24 años,2000,88870,45249,43621
Quintana Roo,20 a 24 años,2005,102042,51828,50214
Quintana Roo,20 a 24 años,2010,128650,65411,63239
Quintana Roo,20 a 24 años,2020,164989,83186,81803
Quintana Roo,15 a 19 años,1990,55940,28691,27249
Quintana Roo,15 a 19 años,1995,75509,38095,37414
Quintana Roo,15 a 19 años,2000,90648,46119,44529
Quintana Roo,15 a 19 años,2005,106745,54091,52654
Quintana Roo,15 a 19 años,2010,121308,61790,59518
Quintana Roo,15 a 19 años,2020,147549,74516,73033
Quintana Roo,100 años y más,1990,56,30,26
Quintana Roo,100 años y más,1995,63,37,26
Quintana Roo,100 años y más,2000,227,136,91
Quintana Roo,100 años y más,2005,205,112,93
Quintana Roo,100 años y más,2010,297,152,145
Quintana Roo,100 años y más,2020,102,66,36
Quintana Roo,10 a 14 años,1990,58780,29888,28892
Quintana Roo,10 a 14 años,1995,77546,39550,37996
Quintana Roo,10 a 14 años,2000,105081,53180,51901
Quintana Roo,10 a 14 años,2005,106802,54551,52251
Quintana Roo,10 a 14 años,2010,126996,64151,62845
Quintana Roo,10 a 14 años,2020,154281,78464,75817
Quintana Roo,0 a 4 años,1990,71097,35966,35131
Quintana Roo,0 a 4 años,1995,96834,49230,47604
Quintana Roo,0 a 4 años,2000,874963,448308,426655
Quintana Roo,0 a 4 años,2005,1135309,574837,560472
Quintana Roo,0 a 4 años,2010,1325578,673220,652358
Quintana Roo,0 a 4 años,2020,147731,75158,72573
San Luis Potosí,No especificado,1990,8873,4320,4553
San Luis Potosí,No especificado,1995,5646,2710,2936
San Luis Potosí,No especificado,2000,580,227,353
San Luis Potosí,No especificado,2005,515,187,328
San Luis Potosí,No especificado,2010,548,205,343
San Luis Potosí,No especificado,2020,1942,964,978
San Luis Potosí,95 a 99 años,1990,1136,475,661
San Luis Potosí,95 a 99 años,1995,1557,689,868
San Luis Potosí,95 a 99 años,2000,3908,1718,2190
San Luis Potosí,95 a 99 años,2005,3817,1670,2147
San Luis Potosí,95 a 99 años,2010,4303,1915,2388
San Luis Potosí,95 a 99 años,2020,2895,1204,1691
San Luis Potosí,90 a 94 años,1990,2773,1259,1514
San Luis Potosí,90 a 94 años,1995,3550,1639,1911
San Luis Potosí,90 a 94 años,2000,8117,3726,4391
San Luis Potosí,90 a 94 años,2005,9094,4254,4840
San Luis Potosí,90 a 94 años,2010,13437,6316,7121
San Luis Potosí,90 a 94 años,2020,8052,3502,4550
San Luis Potosí,85 a 89 años,1990,7510,3587,3923
San Luis Potosí,85 a 89 años,1995,7959,3768,4191
San Luis Potosí,85 a 89 años,2000,12141,5860,6281
San Luis Potosí,85 a 89 años,2005,19149,9277,9872
San Luis Potosí,85 a 89 años,2010,23325,11118,12207
San Luis Potosí,85 a 89 años,2020,18927,8698,10229
San Luis Potosí,80 a 84 años,1990,12274,5827,6447
San Luis Potosí,80 a 84 años,1995,12110,5735,6375
San Luis Potosí,80 a 84 años,2000,24001,12027,11974
San Luis Potosí,80 a 84 años,2005,29792,14795,14997
San Luis Potosí,80 a 84 años,2010,34695,16937,17758
San Luis Potosí,80 a 84 años,2020,32252,14922,17330
San Luis Potosí,75 a 79 años,1990,16253,8027,8226
San Luis Potosí,75 a 79 años,1995,16847,8488,8359
San Luis Potosí,75 a 79 años,2000,34381,17027,17354
San Luis Potosí,75 a 79 años,2005,40409,19645,20764
San Luis Potosí,75 a 79 años,2010,50213,24200,26013
San Luis Potosí,75 a 79 años,2020,45985,22290,23695
San Luis Potosí,70 a 74 años,1990,20470,10187,10283
San Luis Potosí,70 a 74 años,1995,29252,14890,14362
San Luis Potosí,70 a 74 años,2000,44101,21643,22458
San Luis Potosí,70 a 74 años,2005,51272,24723,26549
San Luis Potosí,70 a 74 años,2010,56671,27526,29145
San Luis Potosí,70 a 74 años,2020,63157,30156,33001
San Luis Potosí,65 a 69 años,1990,31872,15960,15912
San Luis Potosí,65 a 69 años,1995,38714,19067,19647
San Luis Potosí,65 a 69 años,2000,57657,27835,29822
San Luis Potosí,65 a 69 años,2005,65308,31164,34144
San Luis Potosí,65 a 69 años,2010,72960,34958,38002
San Luis Potosí,65 a 69 años,2020,82236,39217,43019
San Luis Potosí,60 a 64 años,1990,43493,21396,22097
San Luis Potosí,60 a 64 años,1995,51004,25035,25969
San Luis Potosí,60 a 64 años,2000,62406,30541,31865
San Luis Potosí,60 a 64 años,2005,73276,35625,37651
San Luis Potosí,60 a 64 años,2010,87476,42563,44913
San Luis Potosí,60 a 64 años,2020,107635,51031,56604
San Luis Potosí,55 a 59 años,1990,49815,24679,25136
San Luis Potosí,55 a 59 años,1995,57161,28230,28931
San Luis Potosí,55 a 59 años,2000,78078,37879,40199
San Luis Potosí,55 a 59 años,2005,92388,44537,47851
San Luis Potosí,55 a 59 años,2010,112519,53592,58927
San Luis Potosí,55 a 59 años,2020,125766,59294,66472
San Luis Potosí,50 a 54 años,1990,61690,30305,31385
San Luis Potosí,50 a 54 años,1995,69022,33914,35108
San Luis Potosí,50 a 54 años,2000,91334,44117,47217
San Luis Potosí,50 a 54 años,2005,113281,53881,59400
San Luis Potosí,50 a 54 años,2010,131221,61913,69308
San Luis Potosí,50 a 54 años,2020,153736,72445,81291
San Luis Potosí,5 a 9 años,1990,278401,140173,138228
San Luis Potosí,5 a 9 años,1995,278902,141801,137101
San Luis Potosí,5 a 9 años,2000,268764,135872,132892
San Luis Potosí,5 a 9 años,2005,253580,128094,125486
San Luis Potosí,5 a 9 años,2010,247057,125473,121584
San Luis Potosí,5 a 9 años,2020,242727,122972,119755
San Luis Potosí,45 a 49 años,1990,72233,35211,37022
San Luis Potosí,45 a 49 años,1995,83724,41175,42549
San Luis Potosí,45 a 49 años,2000,115022,55132,59890
San Luis Potosí,45 a 49 años,2005,134538,63383,71155
San Luis Potosí,45 a 49 años,2010,152372,71817,80555
San Luis Potosí,45 a 49 años,2020,169453,80668,88785
San Luis Potosí,40 a 44 años,1990,80896,39374,41522
San Luis Potosí,40 a 44 años,1995,98704,48276,50428
San Luis Potosí,40 a 44 años,2000,139428,65768,73660
San Luis Potosí,40 a 44 años,2005,155867,72725,83142
San Luis Potosí,40 a 44 años,2010,175642,82850,92792
San Luis Potosí,40 a 44 años,2020,180174,85394,94780
San Luis Potosí,35 a 39 años,1990,102364,49465,52899
San Luis Potosí,35 a 39 años,1995,127109,61324,65785
San Luis Potosí,35 a 39 años,2000,155396,72232,83164
San Luis Potosí,35 a 39 años,2005,171383,79159,92224
San Luis Potosí,35 a 39 años,2010,180250,84440,95810
San Luis Potosí,35 a 39 años,2020,191969,90728,101241
San Luis Potosí,30 a 34 años,1990,119334,56953,62381
San Luis Potosí,30 a 34 años,1995,143446,68229,75217
San Luis Potosí,30 a 34 años,2000,173542,80316,93226
San Luis Potosí,30 a 34 años,2005,173849,79474,94375
San Luis Potosí,30 a 34 años,2010,189105,88319,100786
San Luis Potosí,30 a 34 años,2020,204288,96754,107534
San Luis Potosí,25 a 29 años,1990,142709,67273,75436
San Luis Potosí,25 a 29 años,1995,164964,77995,86969
San Luis Potosí,25 a 29 años,2000,198991,92557,106434
San Luis Potosí,25 a 29 años,2005,198562,91177,107385
San Luis Potosí,25 a 29 años,2010,219720,105606,114114
San Luis Potosí,25 a 29 años,2020,220964,106032,114932
San Luis Potosí,20 a 24 años,1990,176897,83499,93398
San Luis Potosí,20 a 24 años,1995,206873,99110,107763
San Luis Potosí,20 a 24 años,2000,241303,117718,123585
San Luis Potosí,20 a 24 años,2005,247158,121587,125571
San Luis Potosí,20 a 24 años,2010,269673,135204,134469
San Luis Potosí,20 a 24 años,2020,232129,113430,118699
San Luis Potosí,15 a 19 años,1990,231951,115288,116663
San Luis Potosí,15 a 19 años,1995,246271,122685,123586
San Luis Potosí,15 a 19 años,2000,277667,140526,137141
San Luis Potosí,15 a 19 años,2005,285397,144282,141115
San Luis Potosí,15 a 19 años,2010,270154,136835,133319
San Luis Potosí,15 a 19 años,2020,253797,127984,125813
San Luis Potosí,100 años y más,1990,529,174,355
San Luis Potosí,100 años y más,1995,403,131,272
San Luis Potosí,100 años y más,2000,1982,855,1127
San Luis Potosí,100 años y más,2005,1978,831,1147
San Luis Potosí,100 años y más,2010,1824,787,1037
San Luis Potosí,100 años y más,2020,460,181,279
San Luis Potosí,10 a 14 años,1990,271005,136540,134465
San Luis Potosí,10 a 14 años,1995,277578,140700,136878
San Luis Potosí,10 a 14 años,2000,290504,147015,143489
San Luis Potosí,10 a 14 años,2005,266312,135091,131221
San Luis Potosí,10 a 14 años,2010,268914,136027,132887
San Luis Potosí,10 a 14 años,2020,252780,128254,124526
San Luis Potosí,0 a 4 años,1990,270709,137343,133366
San Luis Potosí,0 a 4 años,1995,279967,141909,138058
San Luis Potosí,0 a 4 años,2000,2299360,1120837,1178523
San Luis Potosí,0 a 4 años,2005,2410414,1167308,1243106
San Luis Potosí,0 a 4 años,2010,2585518,1260366,1325152
San Luis Potosí,0 a 4 años,2020,230931,116331,114600
Sinaloa,No especificado,1990,12292,6073,6219
Sinaloa,No especificado,1995,3832,1931,1901
Sinaloa,No especificado,2000,459,190,269
Sinaloa,No especificado,2005,411,163,248
Sinaloa,No especificado,2010,418,176,242
Sinaloa,No especificado,2020,2225,1108,1117
Sinaloa,95 a 99 años,1990,868,386,482
Sinaloa,95 a 99 años,1995,1151,513,638
Sinaloa,95 a 99 años,2000,2930,1261,1669
Sinaloa,95 a 99 años,2005,3405,1468,1937
Sinaloa,95 a 99 años,2010,4102,1720,2382
Sinaloa,95 a 99 años,2020,1923,769,1154
Sinaloa,90 a 94 años,1990,2127,941,1186
Sinaloa,90 a 94 años,1995,2358,1037,1321
Sinaloa,90 a 94 años,2000,7860,3526,4334
Sinaloa,90 a 94 años,2005,9116,4071,5045
Sinaloa,90 a 94 años,2010,10809,4777,6032
Sinaloa,90 a 94 años,2020,5997,2483,3514
Sinaloa,85 a 89 años,1990,5042,2268,2774
Sinaloa,85 a 89 años,1995,6781,3057,3724
Sinaloa,85 a 89 años,2000,13422,6292,7130
Sinaloa,85 a 89 años,2005,16422,7701,8721
Sinaloa,85 a 89 años,2010,19463,9028,10435
Sinaloa,85 a 89 años,2020,15827,7041,8786
Sinaloa,80 a 84 años,1990,9823,4547,5276
Sinaloa,80 a 84 años,1995,11668,5445,6223
Sinaloa,80 a 84 años,2000,22153,10939,11214
Sinaloa,80 a 84 años,2005,26535,13077,13458
Sinaloa,80 a 84 años,2010,31659,15461,16198
Sinaloa,80 a 84 años,2020,30957,14451,16506
Sinaloa,75 a 79 años,1990,15816,7961,7855
Sinaloa,75 a 79 años,1995,18345,9100,9245
Sinaloa,75 a 79 años,2000,32080,16165,15915
Sinaloa,75 a 79 años,2005,38183,19176,19007
Sinaloa,75 a 79 años,2010,51023,25289,25734
Sinaloa,75 a 79 años,2020,49051,23904,25147
Sinaloa,70 a 74 años,1990,23040,11463,11577
Sinaloa,70 a 74 años,1995,28195,14339,13856
Sinaloa,70 a 74 años,2000,43760,21897,21863
Sinaloa,70 a 74 años,2005,53783,26831,26952
Sinaloa,70 a 74 años,2010,64032,31842,32190
Sinaloa,70 a 74 años,2020,70677,34107,36570
Sinaloa,65 a 69 años,1990,31281,15954,15327
Sinaloa,65 a 69 años,1995,37861,19148,18713
Sinaloa,65 a 69 años,2000,60539,30717,29822
Sinaloa,65 a 69 años,2005,71711,36009,35702
Sinaloa,65 a 69 años,2010,83594,41082,42512
Sinaloa,65 a 69 años,2020,95056,45164,49892
Sinaloa,60 a 64 años,1990,41621,21257,20364
Sinaloa,60 a 64 años,1995,50727,25879,24848
Sinaloa,60 a 64 años,2000,72198,36751,35447
Sinaloa,60 a 64 años,2005,84875,42299,42576
Sinaloa,60 a 64 años,2010,103936,51030,52906
Sinaloa,60 a 64 años,2020,123628,58938,64690
Sinaloa,55 a 59 años,1990,50913,26374,24539
Sinaloa,55 a 59 años,1995,62917,32389,30528
Sinaloa,55 a 59 años,2000,91022,45766,45256
Sinaloa,55 a 59 años,2005,107972,52869,55103
Sinaloa,55 a 59 años,2010,131472,63091,68381
Sinaloa,55 a 59 años,2020,143385,68641,74744
Sinaloa,50 a 54 años,1990,65843,33749,32094
Sinaloa,50 a 54 años,1995,79839,41054,38785
Sinaloa,50 a 54 años,2000,108884,53727,55157
Sinaloa,50 a 54 años,2005,130129,62475,67654
Sinaloa,50 a 54 años,2010,149915,72394,77521
Sinaloa,50 a 54 años,2020,172094,83272,88822
Sinaloa,5 a 9 años,1990,281174,142135,139039
Sinaloa,5 a 9 años,1995,283285,143939,139346
Sinaloa,5 a 9 años,2000,280226,142796,137430
Sinaloa,5 a 9 años,2005,244907,124872,120035
Sinaloa,5 a 9 años,2010,252443,128664,123779
Sinaloa,5 a 9 años,2020,250496,127811,122685
Sinaloa,45 a 49 años,1990,81853,42140,39713
Sinaloa,45 a 49 años,1995,97272,48985,48287
Sinaloa,45 a 49 años,2000,140257,68165,72092
Sinaloa,45 a 49 años,2005,154173,74352,79821
Sinaloa,45 a 49 años,2010,176453,86505,89948
Sinaloa,45 a 49 años,2020,192589,94386,98203
Sinaloa,40 a 44 años,1990,96614,48726,47888
Sinaloa,40 a 44 años,1995,120409,60004,60405
Sinaloa,40 a 44 años,2000,165228,79430,85798
Sinaloa,40 a 44 años,2005,177043,85905,91138
Sinaloa,40 a 44 años,2010,207622,102184,105438
Sinaloa,40 a 44 años,2020,204309,99977,104332
Sinaloa,35 a 39 años,1990,122698,60397,62301
Sinaloa,35 a 39 años,1995,153271,74295,78976
Sinaloa,35 a 39 años,2000,182741,88252,94489
Sinaloa,35 a 39 años,2005,197089,95801,101288
Sinaloa,35 a 39 años,2010,207002,101645,105357
Sinaloa,35 a 39 años,2020,205540,100764,104776
Sinaloa,30 a 34 años,1990,143223,68835,74388
Sinaloa,30 a 34 años,1995,169208,81771,87437
Sinaloa,30 a 34 años,2000,211879,102847,109032
Sinaloa,30 a 34 años,2005,196928,95435,101493
Sinaloa,30 a 34 años,2010,207840,102082,105758
Sinaloa,30 a 34 años,2020,215491,105280,110211
Sinaloa,25 a 29 años,1990,164727,79037,85690
Sinaloa,25 a 29 años,1995,195551,95466,100085
Sinaloa,25 a 29 años,2000,240944,118951,121993
Sinaloa,25 a 29 años,2005,220179,108293,111886
Sinaloa,25 a 29 años,2010,242907,121634,121273
Sinaloa,25 a 29 años,2020,232316,113467,118849
Sinaloa,20 a 24 años,1990,208619,101847,106772
Sinaloa,20 a 24 años,1995,254765,127511,127254
Sinaloa,20 a 24 años,2000,267418,134696,132722
Sinaloa,20 a 24 años,2005,256624,129543,127081
Sinaloa,20 a 24 años,2010,275540,139206,136334
Sinaloa,20 a 24 años,2020,256990,127976,129014
Sinaloa,15 a 19 años,1990,280493,140816,139677
Sinaloa,15 a 19 años,1995,283114,142881,140233
Sinaloa,15 a 19 años,2000,282780,144221,138559
Sinaloa,15 a 19 años,2005,275179,139909,135270
Sinaloa,15 a 19 años,2010,270555,137580,132975
Sinaloa,15 a 19 años,2020,261581,132551,129030
Sinaloa,100 años y más,1990,470,182,288
Sinaloa,100 años y más,1995,335,137,198
Sinaloa,100 años y más,2000,1379,609,770
Sinaloa,100 años y más,2005,1432,592,840
Sinaloa,100 años y más,2010,1625,665,960
Sinaloa,100 años y más,2020,403,169,234
Sinaloa,10 a 14 años,1990,297270,150517,146753
Sinaloa,10 a 14 años,1995,282968,143623,139345
Sinaloa,10 a 14 años,2000,293365,148806,144559
Sinaloa,10 a 14 años,2005,262539,133821,128718
Sinaloa,10 a 14 años,2010,264538,134710,129828
Sinaloa,10 a 14 años,2020,260172,132511,127661
Sinaloa,0 a 4 años,1990,268247,136016,132231
Sinaloa,0 a 4 años,1995,281823,143911,137912
Sinaloa,0 a 4 años,2000,2536844,1264143,1272701
Sinaloa,0 a 4 años,2005,2608442,1294617,1313825
Sinaloa,0 a 4 años,2010,2767761,1376201,1391560
Sinaloa,0 a 4 años,2020,236236,120045,116191
Sonora,No especificado,1990,14079,7054,7025
Sonora,No especificado,1995,3465,2035,1430
Sonora,No especificado,2000,291,128,163
Sonora,No especificado,2005,214,87,127
Sonora,No especificado,2010,224,87,137
Sonora,No especificado,2020,2725,1364,1361
Sonora,95 a 99 años,1990,473,186,287
Sonora,95 a 99 años,1995,701,305,396
Sonora,95 a 99 años,2000,1964,809,1155
Sonora,95 a 99 años,2005,2323,920,1403
Sonora,95 a 99 años,2010,3075,1247,1828
Sonora,95 a 99 años,2020,1421,539,882
Sonora,90 a 94 años,1990,1335,548,787
Sonora,90 a 94 años,1995,1536,685,851
Sonora,90 a 94 años,2000,5569,2411,3158
Sonora,90 a 94 años,2005,6965,3022,3943
Sonora,90 a 94 años,2010,8961,3937,5024
Sonora,90 a 94 años,2020,4727,1849,2878
Sonora,85 a 89 años,1990,3769,1685,2084
Sonora,85 a 89 años,1995,4846,2144,2702
Sonora,85 a 89 años,2000,10430,4768,5662
Sonora,85 a 89 años,2005,13538,6420,7118
Sonora,85 a 89 años,2010,17019,7746,9273
Sonora,85 a 89 años,2020,13203,5697,7506
Sonora,80 a 84 años,1990,7421,3433,3988
Sonora,80 a 84 años,1995,8887,3981,4906
Sonora,80 a 84 años,2000,19133,9546,9587
Sonora,80 a 84 años,2005,23631,11487,12144
Sonora,80 a 84 años,2010,28060,13585,14475
Sonora,80 a 84 años,2020,26144,11839,14305
Sonora,75 a 79 años,1990,12855,6303,6552
Sonora,75 a 79 años,1995,15612,7755,7857
Sonora,75 a 79 años,2000,28081,13992,14089
Sonora,75 a 79 años,2005,33784,16664,17120
Sonora,75 a 79 años,2010,43912,21279,22633
Sonora,75 a 79 años,2020,41519,19677,21842
Sonora,70 a 74 años,1990,19091,9514,9577
Sonora,70 a 74 años,1995,24339,12493,11846
Sonora,70 a 74 años,2000,38990,19465,19525
Sonora,70 a 74 años,2005,48362,23795,24567
Sonora,70 a 74 años,2010,56240,27424,28816
Sonora,70 a 74 años,2020,61882,29386,32496
Sonora,65 a 69 años,1990,27864,14377,13487
Sonora,65 a 69 años,1995,34319,17249,17070
Sonora,65 a 69 años,2000,52615,26211,26404
Sonora,65 a 69 años,2005,61504,30129,31375
Sonora,65 a 69 años,2010,74443,36506,37937
Sonora,65 a 69 años,2020,87708,42358,45350
Sonora,60 a 64 años,1990,36806,18600,18206
Sonora,60 a 64 años,1995,45734,23133,22601
Sonora,60 a 64 años,2000,61747,30932,30815
Sonora,60 a 64 años,2005,74804,37298,37506
Sonora,60 a 64 años,2010,97274,48466,48808
Sonora,60 a 64 años,2020,121603,58841,62762
Sonora,55 a 59 años,1990,45439,23373,22066
Sonora,55 a 59 años,1995,55615,28127,27488
Sonora,55 a 59 años,2000,80037,40221,39816
Sonora,55 a 59 años,2005,99848,49577,50271
Sonora,55 a 59 años,2010,128595,63397,65198
Sonora,55 a 59 años,2020,140464,68807,71657
Sonora,50 a 54 años,1990,58365,29626,28739
Sonora,50 a 54 años,1995,69920,35410,34510
Sonora,50 a 54 años,2000,99234,49469,49765
Sonora,50 a 54 años,2005,125538,61981,63557
Sonora,50 a 54 años,2010,147842,73258,74584
Sonora,50 a 54 años,2020,170705,84122,86583
Sonora,5 a 9 años,1990,216768,109677,107091
Sonora,5 a 9 años,1995,233167,118417,114750
Sonora,5 a 9 años,2000,244619,124895,119724
Sonora,5 a 9 años,2005,234936,119774,115162
Sonora,5 a 9 años,2010,250969,127915,123054
Sonora,5 a 9 años,2020,246711,125202,121509
Sonora,45 a 49 años,1990,69626,35133,34493
Sonora,45 a 49 años,1995,85758,43323,42435
Sonora,45 a 49 años,2000,131251,65236,66015
Sonora,45 a 49 años,2005,147464,72883,74581
Sonora,45 a 49 años,2010,172253,85722,86531
Sonora,45 a 49 años,2020,192181,96274,95907
Sonora,40 a 44 años,1990,82200,41561,40639
Sonora,40 a 44 años,1995,108710,54787,53923
Sonora,40 a 44 años,2000,154516,76116,78400
Sonora,40 a 44 años,2005,171077,84559,86518
Sonora,40 a 44 años,2010,202731,102169,100562
Sonora,40 a 44 años,2020,203895,101577,102318
Sonora,35 a 39 años,1990,108248,54143,54105
Sonora,35 a 39 años,1995,143298,70923,72375
Sonora,35 a 39 años,2000,172782,84967,87815
Sonora,35 a 39 años,2005,191733,95041,96692
Sonora,35 a 39 años,2010,205910,103146,102764
Sonora,35 a 39 años,2020,207000,103839,103161
Sonora,30 a 34 años,1990,133308,65544,67764
Sonora,30 a 34 años,1995,159506,78380,81126
Sonora,30 a 34 años,2000,195388,96583,98805
Sonora,30 a 34 años,2005,190619,94060,96559
Sonora,30 a 34 años,2010,207251,104540,102711
Sonora,30 a 34 años,2020,215004,107455,107549
Sonora,25 a 29 años,1990,150981,73717,77264
Sonora,25 a 29 años,1995,180457,89374,91083
Sonora,25 a 29 años,2000,210638,104754,105884
Sonora,25 a 29 años,2005,201924,100958,100966
Sonora,25 a 29 años,2010,228147,116320,111827
Sonora,25 a 29 años,2020,227896,114152,113744
Sonora,20 a 24 años,1990,181031,90097,90934
Sonora,20 a 24 años,1995,219665,110207,109458
Sonora,20 a 24 años,2000,218530,110432,108098
Sonora,20 a 24 años,2005,221592,112152,109440
Sonora,20 a 24 años,2010,251510,128406,123104
Sonora,20 a 24 años,2020,247003,125586,121417
Sonora,15 a 19 años,1990,217889,110096,107793
Sonora,15 a 19 años,1995,225130,113890,111240
Sonora,15 a 19 años,2000,228055,115733,112322
Sonora,15 a 19 años,2005,240901,122616,118285
Sonora,15 a 19 años,2010,256883,131336,125547
Sonora,15 a 19 años,2020,255716,130755,124961
Sonora,100 años y más,1990,249,93,156
Sonora,100 años y más,1995,183,63,120
Sonora,100 años y más,2000,872,377,495
Sonora,100 años y más,2005,902,350,552
Sonora,100 años y más,2010,940,364,576
Sonora,100 años y más,2020,197,83,114
Sonora,10 a 14 años,1990,222345,111941,110404
Sonora,10 a 14 años,1995,225173,114032,111141
Sonora,10 a 14 años,2000,246494,125302,121192
Sonora,10 a 14 años,2005,243250,124307,118943
Sonora,10 a 14 años,2010,259950,132598,127352
Sonora,10 a 14 años,2020,258791,132191,126600
Sonora,0 a 4 años,1990,213464,108387,105077
Sonora,0 a 4 años,1995,239515,122220,117295
Sonora,0 a 4 años,2000,2216969,1110590,1106379
Sonora,0 a 4 años,2005,2394861,1198154,1196707
Sonora,0 a 4 años,2010,2662480,1339612,1322868
Sonora,0 a 4 años,2020,218345,110604,107741
Tabasco,No especificado,1990,5407,2676,2731
Tabasco,No especificado,1995,3042,1445,1597
Tabasco,No especificado,2000,573,273,300
Tabasco,No especificado,2005,512,216,296
Tabasco,No especificado,2010,536,235,301
Tabasco,No especificado,2020,876,432,444
Tabasco,95 a 99 años,1990,847,411,436
Tabasco,95 a 99 años,1995,982,484,498
Tabasco,95 a 99 años,2000,2081,1015,1066
Tabasco,95 a 99 años,2005,2051,993,1058
Tabasco,95 a 99 años,2010,2669,1275,1394
Tabasco,95 a 99 años,2020,1677,697,980
Tabasco,90 a 94 años,1990,1601,793,808
Tabasco,90 a 94 años,1995,1715,870,845
Tabasco,90 a 94 años,2000,4324,2114,2210
Tabasco,90 a 94 años,2005,5288,2583,2705
Tabasco,90 a 94 años,2010,7134,3374,3760
Tabasco,90 a 94 años,2020,4337,1957,2380
Tabasco,85 a 89 años,1990,3210,1667,1543
Tabasco,85 a 89 años,1995,3781,1948,1833
Tabasco,85 a 89 años,2000,7156,3607,3549
Tabasco,85 a 89 años,2005,9314,4705,4609
Tabasco,85 a 89 años,2010,12257,6092,6165
Tabasco,85 a 89 años,2020,11315,5262,6053
Tabasco,80 a 84 años,1990,5634,2888,2746
Tabasco,80 a 84 años,1995,6064,3121,2943
Tabasco,80 a 84 años,2000,12879,6724,6155
Tabasco,80 a 84 años,2005,16749,8456,8293
Tabasco,80 a 84 años,2010,21048,10617,10431
Tabasco,80 a 84 años,2020,18674,8952,9722
Tabasco,75 a 79 años,1990,7825,4093,3732
Tabasco,75 a 79 años,1995,9585,4988,4597
Tabasco,75 a 79 años,2000,18952,9894,9058
Tabasco,75 a 79 años,2005,24663,12516,12147
Tabasco,75 a 79 años,2010,32532,15959,16573
Tabasco,75 a 79 años,2020,29521,14369,15152
Tabasco,70 a 74 años,1990,11589,6160,5429
Tabasco,70 a 74 años,1995,15449,8327,7122
Tabasco,70 a 74 años,2000,26854,13283,13571
Tabasco,70 a 74 años,2005,32200,15783,16417
Tabasco,70 a 74 años,2010,38728,18954,19774
Tabasco,70 a 74 años,2020,41845,20321,21524
Tabasco,65 a 69 años,1990,15455,7991,7464
Tabasco,65 a 69 años,1995,21043,10624,10419
Tabasco,65 a 69 años,2000,36344,18246,18098
Tabasco,65 a 69 años,2005,43088,21273,21815
Tabasco,65 a 69 años,2010,51726,25607,26119
Tabasco,65 a 69 años,2020,64809,31582,33227
Tabasco,60 a 64 años,1990,23288,12094,11194
Tabasco,60 a 64 años,1995,30607,15588,15019
Tabasco,60 a 64 años,2000,42339,21172,21167
Tabasco,60 a 64 años,2005,53257,26778,26479
Tabasco,60 a 64 años,2010,72350,35982,36368
Tabasco,60 a 64 años,2020,84886,41416,43470
Tabasco,55 a 59 años,1990,29098,15182,13916
Tabasco,55 a 59 años,1995,36478,18626,17852
Tabasco,55 a 59 años,2000,56490,28725,27765
Tabasco,55 a 59 años,2005,74419,37257,37162
Tabasco,55 a 59 años,2010,95109,46912,48197
Tabasco,55 a 59 años,2020,106647,51906,54741
Tabasco,50 a 54 años,1990,37849,19474,18375
Tabasco,50 a 54 años,1995,46169,23567,22602
Tabasco,50 a 54 años,2000,76068,38312,37756
Tabasco,50 a 54 años,2005,94231,46877,47354
Tabasco,50 a 54 años,2010,116426,57375,59051
Tabasco,50 a 54 años,2020,130575,62842,67733
Tabasco,5 a 9 años,1990,216441,108915,107526
Tabasco,5 a 9 años,1995,224135,113280,110855
Tabasco,5 a 9 años,2000,213787,108402,105385
Tabasco,5 a 9 años,2005,204327,103987,100340
Tabasco,5 a 9 años,2010,223692,114194,109498
Tabasco,5 a 9 años,2020,224058,113706,110352
Tabasco,45 a 49 años,1990,48189,24496,23693
Tabasco,45 a 49 años,1995,61601,31405,30196
Tabasco,45 a 49 años,2000,97004,48328,48676
Tabasco,45 a 49 años,2005,116283,57310,58973
Tabasco,45 a 49 años,2010,136000,66024,69976
Tabasco,45 a 49 años,2020,147298,70224,77074
Tabasco,40 a 44 años,1990,57204,29056,28148
Tabasco,40 a 44 años,1995,79309,40278,39031
Tabasco,40 a 44 años,2000,127391,62556,64835
Tabasco,40 a 44 años,2005,139172,67085,72087
Tabasco,40 a 44 años,2010,164922,78148,86774
Tabasco,40 a 44 años,2020,167602,79123,88479
Tabasco,35 a 39 años,1990,84135,42114,42021
Tabasco,35 a 39 años,1995,110421,54958,55463
Tabasco,35 a 39 años,2000,137071,66120,70951
Tabasco,35 a 39 años,2005,152970,71854,81116
Tabasco,35 a 39 años,2010,174392,81829,92563
Tabasco,35 a 39 años,2020,179476,84231,95245
Tabasco,30 a 34 años,1990,96541,47742,48799
Tabasco,30 a 34 años,1995,123023,60444,62579
Tabasco,30 a 34 años,2000,159811,75114,84697
Tabasco,30 a 34 años,2005,166827,77246,89581
Tabasco,30 a 34 años,2010,185871,87169,98702
Tabasco,30 a 34 años,2020,181427,85667,95760
Tabasco,25 a 29 años,1990,121375,59055,62320
Tabasco,25 a 29 años,1995,143820,69173,74647
Tabasco,25 a 29 años,2000,187604,88414,99190
Tabasco,25 a 29 años,2005,188484,88521,99963
Tabasco,25 a 29 años,2010,206842,100048,106794
Tabasco,25 a 29 años,2020,180324,85425,94899
Tabasco,20 a 24 años,1990,144409,69672,74737
Tabasco,20 a 24 años,1995,180648,86928,93720
Tabasco,20 a 24 años,2000,212731,103712,109019
Tabasco,20 a 24 años,2005,210055,103853,106202
Tabasco,20 a 24 años,2010,224257,111911,112346
Tabasco,20 a 24 años,2020,188555,91925,96630
Tabasco,15 a 19 años,1990,176664,86746,89918
Tabasco,15 a 19 años,1995,207996,102227,105769
Tabasco,15 a 19 años,2000,228638,115487,113151
Tabasco,15 a 19 años,2005,222167,112052,110115
Tabasco,15 a 19 años,2010,220776,111804,108972
Tabasco,15 a 19 años,2020,208660,105289,103371
Tabasco,100 años y más,1990,612,250,362
Tabasco,100 años y más,1995,523,227,296
Tabasco,100 años y más,2000,1225,624,601
Tabasco,100 años y más,2005,1228,605,623
Tabasco,100 años y más,2010,1297,589,708
Tabasco,100 años y más,2020,461,184,277
Tabasco,10 a 14 años,1990,206256,103535,102721
Tabasco,10 a 14 años,1995,225955,114091,111864
Tabasco,10 a 14 años,2000,228831,115198,113633
Tabasco,10 a 14 años,2005,208905,105980,102925
Tabasco,10 a 14 años,2010,225061,114145,110916
Tabasco,10 a 14 años,2020,222698,113492,109206
Tabasco,0 a 4 años,1990,208115,104972,103143
Tabasco,0 a 4 años,1995,216423,109644,106779
Tabasco,0 a 4 años,2000,1891829,934515,957314
Tabasco,0 a 4 años,2005,1989969,977785,1012184
Tabasco,0 a 4 años,2010,2238603,1100758,1137845
Tabasco,0 a 4 años,2020,206877,104669,102208
Tamaulipas,No especificado,1990,18016,8866,9150
Tamaulipas,No especificado,1995,4079,1956,2123
Tamaulipas,No especificado,2000,429,179,250
Tamaulipas,No especificado,2005,429,162,267
Tamaulipas,No especificado,2010,408,169,239
Tamaulipas,No especificado,2020,5654,2820,2834
Tamaulipas,95 a 99 años,1990,806,324,482
Tamaulipas,95 a 99 años,1995,1220,561,659
Tamaulipas,95 a 99 años,2000,3307,1409,1898
Tamaulipas,95 a 99 años,2005,3287,1396,1891
Tamaulipas,95 a 99 años,2010,3852,1589,2263
Tamaulipas,95 a 99 años,2020,2287,912,1375
Tamaulipas,90 a 94 años,1990,2163,949,1214
Tamaulipas,90 a 94 años,1995,2914,1346,1568
Tamaulipas,90 a 94 años,2000,7883,3441,4442
Tamaulipas,90 a 94 años,2005,8759,3889,4870
Tamaulipas,90 a 94 años,2010,12078,5302,6776
Tamaulipas,90 a 94 años,2020,7113,2796,4317
Tamaulipas,85 a 89 años,1990,6873,3203,3670
Tamaulipas,85 a 89 años,1995,7576,3517,4059
Tamaulipas,85 a 89 años,2000,12307,5559,6748
Tamaulipas,85 a 89 años,2005,18581,8412,10169
Tamaulipas,85 a 89 años,2010,22387,10054,12333
Tamaulipas,85 a 89 años,2020,17930,7663,10267
Tamaulipas,80 a 84 años,1990,11754,5450,6304
Tamaulipas,80 a 84 años,1995,11705,5402,6303
Tamaulipas,80 a 84 años,2000,24953,12103,12850
Tamaulipas,80 a 84 años,2005,30697,14479,16218
Tamaulipas,80 a 84 años,2010,35422,16664,18758
Tamaulipas,80 a 84 años,2020,33702,14783,18919
Tamaulipas,75 a 79 años,1990,17318,8237,9081
Tamaulipas,75 a 79 años,1995,17911,8539,9372
Tamaulipas,75 a 79 años,2000,36696,17593,19103
Tamaulipas,75 a 79 años,2005,44260,21037,23223
Tamaulipas,75 a 79 años,2010,53619,25167,28452
Tamaulipas,75 a 79 años,2020,50993,23565,27428
Tamaulipas,70 a 74 años,1990,21998,10647,11351
Tamaulipas,70 a 74 años,1995,31519,15467,16052
Tamaulipas,70 a 74 años,2000,50474,24123,26351
Tamaulipas,70 a 74 años,2005,60579,28743,31836
Tamaulipas,70 a 74 años,2010,66138,31179,34959
Tamaulipas,70 a 74 años,2020,73616,33955,39661
Tamaulipas,65 a 69 años,1990,35940,17599,18341
Tamaulipas,65 a 69 años,1995,43449,21018,22431
Tamaulipas,65 a 69 años,2000,67945,32371,35574
Tamaulipas,65 a 69 años,2005,77434,36895,40539
Tamaulipas,65 a 69 años,2010,89766,42359,47407
Tamaulipas,65 a 69 años,2020,100333,47520,52813
Tamaulipas,60 a 64 años,1990,48780,23683,25097
Tamaulipas,60 a 64 años,1995,59763,29003,30760
Tamaulipas,60 a 64 años,2000,76894,37471,39423
Tamaulipas,60 a 64 años,2005,91480,43967,47513
Tamaulipas,60 a 64 años,2010,109317,53327,55990
Tamaulipas,60 a 64 años,2020,139900,66775,73125
Tamaulipas,55 a 59 años,1990,59066,29068,29998
Tamaulipas,55 a 59 años,1995,70066,34462,35604
Tamaulipas,55 a 59 años,2000,98820,47668,51152
Tamaulipas,55 a 59 años,2005,119530,58365,61165
Tamaulipas,55 a 59 años,2010,147748,71602,76146
Tamaulipas,55 a 59 años,2020,167744,81176,86568
Tamaulipas,50 a 54 años,1990,74561,36189,38372
Tamaulipas,50 a 54 años,1995,86224,42550,43674
Tamaulipas,50 a 54 años,2000,116567,56909,59658
Tamaulipas,50 a 54 años,2005,150775,73401,77374
Tamaulipas,50 a 54 años,2010,177182,86829,90353
Tamaulipas,50 a 54 años,2020,211394,102541,108853
Tamaulipas,5 a 9 años,1990,260284,132176,128108
Tamaulipas,5 a 9 años,1995,270441,138027,132414
Tamaulipas,5 a 9 años,2000,296314,151229,145085
Tamaulipas,5 a 9 años,2005,294740,149599,145141
Tamaulipas,5 a 9 años,2010,302937,154457,148480
Tamaulipas,5 a 9 años,2020,294344,149315,145029
Tamaulipas,45 a 49 años,1990,87714,43149,44565
Tamaulipas,45 a 49 años,1995,103927,50597,53330
Tamaulipas,45 a 49 años,2000,154690,75506,79184
Tamaulipas,45 a 49 años,2005,185155,90750,94405
Tamaulipas,45 a 49 años,2010,213736,104304,109432
Tamaulipas,45 a 49 años,2020,236202,115498,120704
Tamaulipas,40 a 44 años,1990,100806,48771,52035
Tamaulipas,40 a 44 años,1995,126389,62336,64053
Tamaulipas,40 a 44 años,2000,190906,93099,97807
Tamaulipas,40 a 44 años,2005,223045,108728,114317
Tamaulipas,40 a 44 años,2010,250586,122278,128308
Tamaulipas,40 a 44 años,2020,248637,120639,127998
Tamaulipas,35 a 39 años,1990,127147,61796,65351
Tamaulipas,35 a 39 años,1995,168254,82499,85755
Tamaulipas,35 a 39 años,2000,222680,108057,114623
Tamaulipas,35 a 39 años,2005,248444,120474,127970
Tamaulipas,35 a 39 años,2010,255313,124108,131205
Tamaulipas,35 a 39 años,2020,257220,125261,131959
Tamaulipas,30 a 34 años,1990,157309,76115,81194
Tamaulipas,30 a 34 años,1995,195075,95548,99527
Tamaulipas,30 a 34 años,2000,252514,122317,130197
Tamaulipas,30 a 34 años,2005,253314,122825,130489
Tamaulipas,30 a 34 años,2010,258116,126215,131901
Tamaulipas,30 a 34 años,2020,256845,125288,131557
Tamaulipas,25 a 29 años,1990,188111,91069,97042
Tamaulipas,25 a 29 años,1995,229796,111930,117866
Tamaulipas,25 a 29 años,2000,272292,132737,139555
Tamaulipas,25 a 29 años,2005,267644,131056,136588
Tamaulipas,25 a 29 años,2010,275453,137058,138395
Tamaulipas,25 a 29 años,2020,267261,131093,136168
Tamaulipas,20 a 24 años,1990,231171,112132,119039
Tamaulipas,20 a 24 años,1995,274901,134302,140599
Tamaulipas,20 a 24 años,2000,271411,134951,136460
Tamaulipas,20 a 24 años,2005,274245,138074,136171
Tamaulipas,20 a 24 años,2010,291682,147251,144431
Tamaulipas,20 a 24 años,2020,284064,142117,141947
Tamaulipas,15 a 19 años,1990,273793,136022,137771
Tamaulipas,15 a 19 años,1995,275684,137625,138059
Tamaulipas,15 a 19 años,2000,270114,137462,132652
Tamaulipas,15 a 19 años,2005,290402,147498,142904
Tamaulipas,15 a 19 años,2010,294469,150104,144365
Tamaulipas,15 a 19 años,2020,294950,149235,145715
Tamaulipas,100 años y más,1990,346,136,210
Tamaulipas,100 años y más,1995,296,116,180
Tamaulipas,100 años y más,2000,1680,727,953
Tamaulipas,100 años y más,2005,1450,605,845
Tamaulipas,100 años y más,2010,1427,574,853
Tamaulipas,100 años y más,2020,353,146,207
Tamaulipas,10 a 14 años,1990,268815,135450,133365
Tamaulipas,10 a 14 años,1995,263237,133432,129805
Tamaulipas,10 a 14 años,2000,294747,149746,145001
Tamaulipas,10 a 14 años,2005,295298,150744,144554
Tamaulipas,10 a 14 años,2010,305122,154618,150504
Tamaulipas,10 a 14 años,2020,305853,155866,149987
Tamaulipas,0 a 4 años,1990,256810,130667,126143
Tamaulipas,0 a 4 años,1995,282902,144467,138435
Tamaulipas,0 a 4 años,2000,2753222,1359874,1393348
Tamaulipas,0 a 4 años,2005,3024238,1493573,1530665
Tamaulipas,0 a 4 años,2010,3268554,1616201,1652353
Tamaulipas,0 a 4 años,2020,271340,137176,134164
Tlaxcala,No especificado,1990,847,400,447
Tlaxcala,No especificado,1995,698,321,377
Tlaxcala,No especificado,2000,200,68,132
Tlaxcala,No especificado,2005,188,69,119
Tlaxcala,No especificado,2010,187,75,112
Tlaxcala,No especificado,2020,20925,10419,10506
Tlaxcala,95 a 99 años,1990,530,195,335
Tlaxcala,95 a 99 años,1995,643,268,375
Tlaxcala,95 a 99 años,2000,1392,623,769
Tlaxcala,95 a 99 años,2005,1502,664,838
Tlaxcala,95 a 99 años,2010,1997,880,1117
Tlaxcala,95 a 99 años,2020,1231,532,699
Tlaxcala,90 a 94 años,1990,985,467,518
Tlaxcala,90 a 94 años,1995,1238,557,681
Tlaxcala,90 a 94 años,2000,3366,1531,1835
Tlaxcala,90 a 94 años,2005,4171,1922,2249
Tlaxcala,90 a 94 años,2010,5477,2493,2984
Tlaxcala,90 a 94 años,2020,3217,1353,1864
Tlaxcala,85 a 89 años,1990,2832,1296,1536
Tlaxcala,85 a 89 años,1995,3127,1477,1650
Tlaxcala,85 a 89 años,2000,5308,2544,2764
Tlaxcala,85 a 89 años,2005,7232,3382,3850
Tlaxcala,85 a 89 años,2010,8741,4056,4685
Tlaxcala,85 a 89 años,2020,7325,3225,4100
Tlaxcala,80 a 84 años,1990,4143,1991,2152
Tlaxcala,80 a 84 años,1995,4334,2094,2240
Tlaxcala,80 a 84 años,2000,9585,4700,4885
Tlaxcala,80 a 84 años,2005,11317,5460,5857
Tlaxcala,80 a 84 años,2010,13009,6108,6901
Tlaxcala,80 a 84 años,2020,11591,5335,6256
Tlaxcala,75 a 79 años,1990,6354,3203,3151
Tlaxcala,75 a 79 años,1995,7367,3620,3747
Tlaxcala,75 a 79 años,2000,12377,6038,6339
Tlaxcala,75 a 79 años,2005,14576,6904,7672
Tlaxcala,75 a 79 años,2010,17497,8197,9300
Tlaxcala,75 a 79 años,2020,17367,8240,9127
Tlaxcala,70 a 74 años,1990,8284,4012,4272
Tlaxcala,70 a 74 años,1995,10838,5324,5514
Tlaxcala,70 a 74 años,2000,16582,7743,8839
Tlaxcala,70 a 74 años,2005,18889,8873,10016
Tlaxcala,70 a 74 años,2010,21997,10353,11644
Tlaxcala,70 a 74 años,2020,24495,11325,13170
Tlaxcala,65 a 69 años,1990,12043,5870,6173
Tlaxcala,65 a 69 años,1995,14448,6931,7517
Tlaxcala,65 a 69 años,2000,20010,9496,10514
Tlaxcala,65 a 69 años,2005,24137,11552,12585
Tlaxcala,65 a 69 años,2010,28530,13597,14933
Tlaxcala,65 a 69 años,2020,33958,15919,18039
Tlaxcala,60 a 64 años,1990,14949,7334,7615
Tlaxcala,60 a 64 años,1995,18174,8695,9479
Tlaxcala,60 a 64 años,2000,22869,11097,11772
Tlaxcala,60 a 64 años,2005,28757,13902,14855
Tlaxcala,60 a 64 años,2010,36171,17210,18961
Tlaxcala,60 a 64 años,2020,46505,21684,24821
Tlaxcala,55 a 59 años,1990,17599,8478,9121
Tlaxcala,55 a 59 años,1995,20211,9745,10466
Tlaxcala,55 a 59 años,2000,29923,14389,15534
Tlaxcala,55 a 59 años,2005,37925,18030,19895
Tlaxcala,55 a 59 años,2010,49362,23079,26283
Tlaxcala,55 a 59 años,2020,56315,26186,30129
Tlaxcala,50 a 54 años,1990,20869,10037,10832
Tlaxcala,50 a 54 años,1995,25113,12321,12792
Tlaxcala,50 a 54 años,2000,36434,17540,18894
Tlaxcala,50 a 54 años,2005,48794,22995,25799
Tlaxcala,50 a 54 años,2010,58822,27512,31310
Tlaxcala,50 a 54 años,2020,70782,32540,38242
Tlaxcala,5 a 9 años,1990,107483,53958,53525
Tlaxcala,5 a 9 años,1995,109410,55694,53716
Tlaxcala,5 a 9 años,2000,108862,55386,53476
Tlaxcala,5 a 9 años,2005,114954,58574,56380
Tlaxcala,5 a 9 años,2010,116073,58980,57093
Tlaxcala,5 a 9 años,2020,117738,59685,58053
Tlaxcala,45 a 49 años,1990,25549,12476,13073
Tlaxcala,45 a 49 años,1995,31649,15480,16169
Tlaxcala,45 a 49 años,2000,48701,23243,25458
Tlaxcala,45 a 49 años,2005,59577,28186,31391
Tlaxcala,45 a 49 años,2010,71030,33139,37891
Tlaxcala,45 a 49 años,2020,80395,37282,43113
Tlaxcala,40 a 44 años,1990,29399,14427,14972
Tlaxcala,40 a 44 años,1995,38503,18878,19625
Tlaxcala,40 a 44 años,2000,61295,28977,32318
Tlaxcala,40 a 44 años,2005,72699,33984,38715
Tlaxcala,40 a 44 años,2010,84560,39297,45263
Tlaxcala,40 a 44 años,2020,89448,41550,47898
Tlaxcala,35 a 39 años,1990,39473,19043,20430
Tlaxcala,35 a 39 años,1995,54029,25910,28119
Tlaxcala,35 a 39 años,2000,69785,32599,37186
Tlaxcala,35 a 39 años,2005,81874,37734,44140
Tlaxcala,35 a 39 años,2010,90612,41672,48940
Tlaxcala,35 a 39 años,2020,94896,43586,51310
Tlaxcala,30 a 34 años,1990,48100,22925,25175
Tlaxcala,30 a 34 años,1995,61544,29238,32306
Tlaxcala,30 a 34 años,2000,79360,37296,42064
Tlaxcala,30 a 34 años,2005,88678,40707,47971
Tlaxcala,30 a 34 años,2010,93720,43235,50485
Tlaxcala,30 a 34 años,2020,96512,45384,51128
Tlaxcala,25 a 29 años,1990,57606,27447,30159
Tlaxcala,25 a 29 años,1995,71169,33868,37301
Tlaxcala,25 a 29 años,2000,95999,45652,50347
Tlaxcala,25 a 29 años,2005,99680,46429,53251
Tlaxcala,25 a 29 años,2010,104781,50406,54375
Tlaxcala,25 a 29 años,2020,104758,50890,53868
Tlaxcala,20 a 24 años,1990,71689,34424,37265
Tlaxcala,20 a 24 años,1995,90107,43311,46796
Tlaxcala,20 a 24 años,2000,106450,52418,54032
Tlaxcala,20 a 24 años,2005,108254,53846,54408
Tlaxcala,20 a 24 años,2010,119172,59831,59341
Tlaxcala,20 a 24 años,2020,113937,56738,57199
Tlaxcala,15 a 19 años,1990,89788,44518,45270
Tlaxcala,15 a 19 años,1995,103743,51416,52327
Tlaxcala,15 a 19 años,2000,110488,56118,54370
Tlaxcala,15 a 19 años,2005,118450,60021,58429
Tlaxcala,15 a 19 años,2010,118634,59970,58664
Tlaxcala,15 a 19 años,2020,121207,61532,59675
Tlaxcala,100 años y más,1990,176,53,123
Tlaxcala,100 años y más,1995,138,43,95
Tlaxcala,100 años y más,2000,828,361,467
Tlaxcala,100 años y más,2005,794,331,463
Tlaxcala,100 años y más,2010,794,318,476
Tlaxcala,100 años y más,2020,197,57,140
Tlaxcala,10 a 14 años,1990,104575,52735,51840
Tlaxcala,10 a 14 años,1995,110597,55744,54853
Tlaxcala,10 a 14 años,2000,115925,58718,57207
Tlaxcala,10 a 14 años,2005,114239,58160,56079
Tlaxcala,10 a 14 años,2010,123330,62673,60657
Tlaxcala,10 a 14 años,2020,119718,60747,58971
Tlaxcala,0 a 4 años,1990,98004,49841,48163
Tlaxcala,0 a 4 años,1995,106844,54455,52389
Tlaxcala,0 a 4 años,2000,962646,469948,492698
Tlaxcala,0 a 4 años,2005,1068207,517477,550730
Tlaxcala,0 a 4 años,2010,1169936,565775,604161
Tlaxcala,0 a 4 años,2020,110460,55685,54775
Veracruz de Ignacio de la Llave,No especificado,1990,26647,12969,13678
Veracruz de Ignacio de la Llave,No especificado,1995,10817,4886,5931
Veracruz de Ignacio de la Llave,No especificado,2000,2261,913,1348
Veracruz de Ignacio de la Llave,No especificado,2005,2115,817,1298
Veracruz de Ignacio de la Llave,No especificado,2010,2186,890,1296
Veracruz de Ignacio de la Llave,No especificado,2020,3470,1707,1763
Veracruz de Ignacio de la Llave,95 a 99 años,1990,3614,1521,2093
Veracruz de Ignacio de la Llave,95 a 99 años,1995,4665,2070,2595
Veracruz de Ignacio de la Llave,95 a 99 años,2000,9608,4171,5437
Veracruz de Ignacio de la Llave,95 a 99 años,2005,10668,4500,6168
Veracruz de Ignacio de la Llave,95 a 99 años,2010,13213,5571,7642
Veracruz de Ignacio de la Llave,95 a 99 años,2020,8304,3328,4976
Veracruz de Ignacio de la Llave,90 a 94 años,1990,7843,3421,4422
Veracruz de Ignacio de la Llave,90 a 94 años,1995,8609,3695,4914
Veracruz de Ignacio de la Llave,90 a 94 años,2000,22336,9680,12656
Veracruz de Ignacio de la Llave,90 a 94 años,2005,27716,12147,15569
Veracruz de Ignacio de la Llave,90 a 94 años,2010,35565,15779,19786
Veracruz de Ignacio de la Llave,90 a 94 años,2020,21825,9066,12759
Veracruz de Ignacio de la Llave,85 a 89 años,1990,16879,7679,9200
Veracruz de Ignacio de la Llave,85 a 89 años,1995,19582,8781,10801
Veracruz de Ignacio de la Llave,85 a 89 años,2000,36758,16776,19982
Veracruz de Ignacio de la Llave,85 a 89 años,2005,50171,23047,27124
Veracruz de Ignacio de la Llave,85 a 89 años,2010,62627,28294,34333
Veracruz de Ignacio de la Llave,85 a 89 años,2020,54398,23684,30714
Veracruz de Ignacio de la Llave,80 a 84 años,1990,29753,13525,16228
Veracruz de Ignacio de la Llave,80 a 84 años,1995,32694,14679,18015
Veracruz de Ignacio de la Llave,80 a 84 años,2000,66604,32117,34487
Veracruz de Ignacio de la Llave,80 a 84 años,2005,85434,40350,45084
Veracruz de Ignacio de la Llave,80 a 84 años,2010,100119,46658,53461
Veracruz de Ignacio de la Llave,80 a 84 años,2020,95232,43082,52150
Veracruz de Ignacio de la Llave,75 a 79 años,1990,44526,21258,23268
Veracruz de Ignacio de la Llave,75 a 79 años,1995,51656,24807,26849
Veracruz de Ignacio de la Llave,75 a 79 años,2000,97101,46706,50395
Veracruz de Ignacio de la Llave,75 a 79 años,2005,121464,57509,63955
Veracruz de Ignacio de la Llave,75 a 79 años,2010,155346,72547,82799
Veracruz de Ignacio de la Llave,75 a 79 años,2020,145737,68964,76773
Veracruz de Ignacio de la Llave,70 a 74 años,1990,63720,30885,32835
Veracruz de Ignacio de la Llave,70 a 74 años,1995,82096,40157,41939
Veracruz de Ignacio de la Llave,70 a 74 años,2000,132984,62339,70645
Veracruz de Ignacio de la Llave,70 a 74 años,2005,159801,75256,84545
Veracruz de Ignacio de la Llave,70 a 74 años,2010,183836,87365,96471
Veracruz de Ignacio de la Llave,70 a 74 años,2020,203156,95435,107721
Veracruz de Ignacio de la Llave,65 a 69 años,1990,90139,43691,46448
Veracruz de Ignacio de la Llave,65 a 69 años,1995,112997,53595,59402
Veracruz de Ignacio de la Llave,65 a 69 años,2000,178582,85264,93318
Veracruz de Ignacio de la Llave,65 a 69 años,2005,211512,100645,110867
Veracruz de Ignacio de la Llave,65 a 69 años,2010,239698,114048,125650
Veracruz de Ignacio de la Llave,65 a 69 años,2020,279233,130731,148502
Veracruz de Ignacio de la Llave,60 a 64 años,1990,127548,61852,65696
Veracruz de Ignacio de la Llave,60 a 64 años,1995,154740,74398,80342
Veracruz de Ignacio de la Llave,60 a 64 años,2000,205722,99382,106340
Veracruz de Ignacio de la Llave,60 a 64 años,2005,247750,119097,128653
Veracruz de Ignacio de la Llave,60 a 64 años,2010,298171,142619,155552
Veracruz de Ignacio de la Llave,60 a 64 años,2020,347850,162999,184851
Veracruz de Ignacio de la Llave,55 a 59 años,1990,152200,74293,77907
Veracruz de Ignacio de la Llave,55 a 59 años,1995,183424,89307,94117
Veracruz de Ignacio de la Llave,55 a 59 años,2000,259882,125663,134219
Veracruz de Ignacio de la Llave,55 a 59 años,2005,310556,148137,162419
Veracruz de Ignacio de la Llave,55 a 59 años,2010,365591,172802,192789
Veracruz de Ignacio de la Llave,55 a 59 años,2020,408710,192522,216188
Veracruz de Ignacio de la Llave,50 a 54 años,1990,194181,95161,99020
Veracruz de Ignacio de la Llave,50 a 54 años,1995,227050,111635,115415
Veracruz de Ignacio de la Llave,50 a 54 años,2000,312790,149441,163349
Veracruz de Ignacio de la Llave,50 a 54 años,2005,369611,175365,194246
Veracruz de Ignacio de la Llave,50 a 54 años,2010,424845,201515,223330
Veracruz de Ignacio de la Llave,50 a 54 años,2020,488510,227672,260838
Veracruz de Ignacio de la Llave,5 a 9 años,1990,821633,416819,404814
Veracruz de Ignacio de la Llave,5 a 9 años,1995,808231,410700,397531
Veracruz de Ignacio de la Llave,5 a 9 años,2000,728473,369566,358907
Veracruz de Ignacio de la Llave,5 a 9 años,2005,676902,344371,332531
Veracruz de Ignacio de la Llave,5 a 9 años,2010,662288,335899,326389
Veracruz de Ignacio de la Llave,5 a 9 años,2020,675182,342335,332847
Veracruz de Ignacio de la Llave,45 a 49 años,1990,240187,118069,122118
Veracruz de Ignacio de la Llave,45 a 49 años,1995,284928,139122,145806
Veracruz de Ignacio de la Llave,45 a 49 años,2000,380702,181477,199225
Veracruz de Ignacio de la Llave,45 a 49 años,2005,432692,203928,228764
Veracruz de Ignacio de la Llave,45 a 49 años,2010,486810,228657,258153
Veracruz de Ignacio de la Llave,45 a 49 años,2020,516152,240159,275993
Veracruz de Ignacio de la Llave,40 a 44 años,1990,276466,135545,140921
Veracruz de Ignacio de la Llave,40 a 44 años,1995,336144,164379,171765
Veracruz de Ignacio de la Llave,40 a 44 años,2000,459768,217408,242360
Veracruz de Ignacio de la Llave,40 a 44 años,2005,496595,229601,266994
Veracruz de Ignacio de la Llave,40 a 44 años,2010,542754,251277,291477
Veracruz de Ignacio de la Llave,40 a 44 años,2020,537667,247288,290379
Veracruz de Ignacio de la Llave,35 a 39 años,1990,361668,174334,187334
Veracruz de Ignacio de la Llave,35 a 39 años,1995,432316,208089,224227
Veracruz de Ignacio de la Llave,35 a 39 años,2000,498825,233227,265598
Veracruz de Ignacio de la Llave,35 a 39 años,2005,516830,234539,282291
Veracruz de Ignacio de la Llave,35 a 39 años,2010,539685,247094,292591
Veracruz de Ignacio de la Llave,35 a 39 años,2020,558791,258605,300186
Veracruz de Ignacio de la Llave,30 a 34 años,1990,405322,195773,209549
Veracruz de Ignacio de la Llave,30 a 34 años,1995,474740,228981,245759
Veracruz de Ignacio de la Llave,30 a 34 años,2000,536397,246494,289903
Veracruz de Ignacio de la Llave,30 a 34 años,2005,517828,232501,285327
Veracruz de Ignacio de la Llave,30 a 34 años,2010,557762,259153,298609
Veracruz de Ignacio de la Llave,30 a 34 años,2020,568121,263409,304712
Veracruz de Ignacio de la Llave,25 a 29 años,1990,485425,233676,251749
Veracruz de Ignacio de la Llave,25 a 29 años,1995,543854,259835,284019
Veracruz de Ignacio de la Llave,25 a 29 años,2000,593263,274257,319006
Veracruz de Ignacio de la Llave,25 a 29 años,2005,582248,269012,313236
Veracruz de Ignacio de la Llave,25 a 29 años,2010,642093,307562,334531
Veracruz de Ignacio de la Llave,25 a 29 años,2020,580421,272684,307737
Veracruz de Ignacio de la Llave,20 a 24 años,1990,589326,284723,304603
Veracruz de Ignacio de la Llave,20 a 24 años,1995,647799,311116,336683
Veracruz de Ignacio de la Llave,20 a 24 años,2000,709056,349083,359973
Veracruz de Ignacio de la Llave,20 a 24 años,2005,710167,351004,359163
Veracruz de Ignacio de la Llave,20 a 24 años,2010,759388,381351,378037
Veracruz de Ignacio de la Llave,20 a 24 años,2020,600394,292359,308035
Veracruz de Ignacio de la Llave,15 a 19 años,1990,715415,356386,359029
Veracruz de Ignacio de la Llave,15 a 19 años,1995,735362,366861,368501
Veracruz de Ignacio de la Llave,15 a 19 años,2000,797328,404351,392977
Veracruz de Ignacio de la Llave,15 a 19 años,2005,791110,401867,389243
Veracruz de Ignacio de la Llave,15 a 19 años,2010,741526,376924,364602
Veracruz de Ignacio de la Llave,15 a 19 años,2020,681548,344153,337395
Veracruz de Ignacio de la Llave,100 años y más,1990,2389,925,1464
Veracruz de Ignacio de la Llave,100 años y más,1995,1732,645,1087
Veracruz de Ignacio de la Llave,100 años y más,2000,5467,2363,3104
Veracruz de Ignacio de la Llave,100 años y más,2005,5679,2313,3366
Veracruz de Ignacio de la Llave,100 años y más,2010,5967,2503,3464
Veracruz de Ignacio de la Llave,100 años y más,2020,2157,799,1358
Veracruz de Ignacio de la Llave,10 a 14 años,1990,795938,401438,394500
Veracruz de Ignacio de la Llave,10 a 14 años,1995,807421,410912,396509
Veracruz de Ignacio de la Llave,10 a 14 años,2000,812674,412270,400404
Veracruz de Ignacio de la Llave,10 a 14 años,2005,720700,366110,354590
Veracruz de Ignacio de la Llave,10 a 14 años,2010,728767,369775,358992
Veracruz de Ignacio de la Llave,10 a 14 años,2020,685468,347680,337788
Veracruz de Ignacio de la Llave,0 a 4 años,1990,777420,393484,383936
Veracruz de Ignacio de la Llave,0 a 4 años,1995,776467,395230,381237
Veracruz de Ignacio de la Llave,0 a 4 años,2000,6908975,3355164,3553811
Veracruz de Ignacio de la Llave,0 a 4 años,2005,7110214,3423379,3686835
Veracruz de Ignacio de la Llave,0 a 4 años,2010,7643194,3695679,3947515
Veracruz de Ignacio de la Llave,0 a 4 años,2020,600253,303113,297140
Yucatán,No especificado,1990,4080,1983,2097
Yucatán,No especificado,1995,2691,1382,1309
Yucatán,No especificado,2000,230,107,123
Yucatán,No especificado,2005,182,69,113
Yucatán,No especificado,2010,202,88,114
Yucatán,No especificado,2020,3816,1896,1920
Yucatán,95 a 99 años,1990,655,298,357
Yucatán,95 a 99 años,1995,794,377,417
Yucatán,95 a 99 años,2000,2419,1138,1281
Yucatán,95 a 99 años,2005,2818,1289,1529
Yucatán,95 a 99 años,2010,3815,1743,2072
Yucatán,95 a 99 años,2020,1556,640,916
Yucatán,90 a 94 años,1990,1736,792,944
Yucatán,90 a 94 años,1995,2127,998,1129
Yucatán,90 a 94 años,2000,6478,3108,3370
Yucatán,90 a 94 años,2005,8573,4172,4401
Yucatán,90 a 94 años,2010,9540,4618,4922
Yucatán,90 a 94 años,2020,4647,2023,2624
Yucatán,85 a 89 años,1990,4899,2379,2520
Yucatán,85 a 89 años,1995,5616,2769,2847
Yucatán,85 a 89 años,2000,12282,5991,6291
Yucatán,85 a 89 años,2005,14293,6968,7325
Yucatán,85 a 89 años,2010,15627,7491,8136
Yucatán,85 a 89 años,2020,12224,5530,6694
Yucatán,80 a 84 años,1990,8704,4298,4406
Yucatán,80 a 84 años,1995,9959,4847,5112
Yucatán,80 a 84 años,2000,19372,9775,9597
Yucatán,80 a 84 años,2005,21195,10674,10521
Yucatán,80 a 84 años,2010,24558,12071,12487
Yucatán,80 a 84 años,2020,22476,10519,11957
Yucatán,75 a 79 años,1990,13802,7123,6679
Yucatán,75 a 79 años,1995,16966,8731,8235
Yucatán,75 a 79 años,2000,24429,12129,12300
Yucatán,75 a 79 años,2005,28422,13928,14494
Yucatán,75 a 79 años,2010,35779,17334,18445
Yucatán,75 a 79 años,2020,35612,17163,18449
Yucatán,70 a 74 años,1990,20263,10390,9873
Yucatán,70 a 74 años,1995,23662,12011,11651
Yucatán,70 a 74 años,2000,31712,15476,16236
Yucatán,70 a 74 años,2005,38247,18600,19647
Yucatán,70 a 74 años,2010,44092,21271,22821
Yucatán,70 a 74 años,2020,53224,25378,27846
Yucatán,65 a 69 años,1990,25855,12918,12937
Yucatán,65 a 69 años,1995,27734,13676,14058
Yucatán,65 a 69 años,2000,40706,19687,21019
Yucatán,65 a 69 años,2005,48236,23013,25223
Yucatán,65 a 69 años,2010,61572,29647,31925
Yucatán,65 a 69 años,2020,72318,34270,38048
Yucatán,60 a 64 años,1990,30299,14800,15499
Yucatán,60 a 64 años,1995,35797,17516,18281
Yucatán,60 a 64 años,2000,47242,22922,24320
Yucatán,60 a 64 años,2005,61894,30238,31656
Yucatán,60 a 64 años,2010,73419,35354,38065
Yucatán,60 a 64 años,2020,86773,40883,45890
Yucatán,55 a 59 años,1990,34702,16975,17727
Yucatán,55 a 59 años,1995,41577,20340,21237
Yucatán,55 a 59 años,2000,63846,31152,32694
Yucatán,55 a 59 años,2005,76900,36800,40100
Yucatán,55 a 59 años,2010,87918,41814,46104
Yucatán,55 a 59 años,2020,103183,48826,54357
Yucatán,50 a 54 años,1990,42970,21001,21969
Yucatán,50 a 54 años,1995,51694,25443,26251
Yucatán,50 a 54 años,2000,74855,36168,38687
Yucatán,50 a 54 años,2005,86897,41778,45119
Yucatán,50 a 54 años,2010,101202,48528,52674
Yucatán,50 a 54 años,2020,122358,57886,64472
Yucatán,5 a 9 años,1990,174028,88058,85970
Yucatán,5 a 9 años,1995,182490,92524,89966
Yucatán,5 a 9 años,2000,173213,88088,85125
Yucatán,5 a 9 años,2005,169575,85966,83609
Yucatán,5 a 9 años,2010,170727,86219,84508
Yucatán,5 a 9 años,2020,186122,93902,92220
Yucatán,45 a 49 años,1990,52521,25916,26605
Yucatán,45 a 49 años,1995,68487,33760,34727
Yucatán,45 a 49 años,2000,87383,42447,44936
Yucatán,45 a 49 años,2005,103126,49655,53471
Yucatán,45 a 49 años,2010,116699,56265,60434
Yucatán,45 a 49 años,2020,146033,70247,75786
Yucatán,40 a 44 años,1990,64275,31759,32516
Yucatán,40 a 44 años,1995,79077,38730,40347
Yucatán,40 a 44 años,2000,104381,50181,54200
Yucatán,40 a 44 años,2005,118211,56944,61267
Yucatán,40 a 44 años,2010,145205,69998,75207
Yucatán,40 a 44 años,2020,161231,77759,83472
Yucatán,35 a 39 años,1990,79634,38481,41153
Yucatán,35 a 39 años,1995,95371,46353,49018
Yucatán,35 a 39 años,2000,114882,55218,59664
Yucatán,35 a 39 años,2005,139475,67053,72422
Yucatán,35 a 39 años,2010,151440,73129,78311
Yucatán,35 a 39 años,2020,174099,84877,89222
Yucatán,30 a 34 años,1990,86739,42043,44696
Yucatán,30 a 34 años,1995,105949,51436,54513
Yucatán,30 a 34 años,2000,136614,65813,70801
Yucatán,30 a 34 años,2005,147473,71543,75930
Yucatán,30 a 34 años,2010,160355,78443,81912
Yucatán,30 a 34 años,2020,183035,89203,93832
Yucatán,25 a 29 años,1990,100526,48128,52398
Yucatán,25 a 29 años,1995,120066,58455,61611
Yucatán,25 a 29 años,2000,160339,78157,82182
Yucatán,25 a 29 años,2005,171550,84185,87365
Yucatán,25 a 29 años,2010,183322,91013,92309
Yucatán,25 a 29 años,2020,190975,94526,96449
Yucatán,20 a 24 años,1990,121572,58580,62992
Yucatán,20 a 24 años,1995,157458,77339,80119
Yucatán,20 a 24 años,2000,175320,86908,88412
Yucatán,20 a 24 años,2005,183960,91950,92010
Yucatán,20 a 24 años,2010,192027,96613,95414
Yucatán,20 a 24 años,2020,199525,100085,99440
Yucatán,15 a 19 años,1990,155653,76134,79519
Yucatán,15 a 19 años,1995,170674,84925,85749
Yucatán,15 a 19 años,2000,183581,92863,90718
Yucatán,15 a 19 años,2005,188049,95354,92695
Yucatán,15 a 19 años,2010,182604,92921,89683
Yucatán,15 a 19 años,2020,196363,99417,96946
Yucatán,100 años y más,1990,192,80,112
Yucatán,100 años y más,1995,147,64,83
Yucatán,100 años y más,2000,1007,463,544
Yucatán,100 años y más,2005,1110,517,593
Yucatán,100 años y más,2010,1289,586,703
Yucatán,100 años y más,2020,205,81,124
Yucatán,10 a 14 años,1990,169408,85649,83759
Yucatán,10 a 14 años,1995,180223,91435,88788
Yucatán,10 a 14 años,2000,185605,93955,91650
Yucatán,10 a 14 años,2005,176491,89687,86804
Yucatán,10 a 14 años,2010,181587,91892,89695
Yucatán,10 a 14 años,2020,189137,95833,93304
Yucatán,0 a 4 años,1990,170427,86107,84320
Yucatán,0 a 4 años,1995,178063,90324,87739
Yucatán,0 a 4 años,2000,1658210,818205,840005
Yucatán,0 a 4 años,2005,1818948,896562,922386
Yucatán,0 a 4 años,2010,1955577,963333,992244
Yucatán,0 a 4 años,2020,175986,89335,86651
Zacatecas,No especificado,1990,3095,1496,1599
Zacatecas,No especificado,1995,2205,1010,1195
Zacatecas,No especificado,2000,260,110,150
Zacatecas,No especificado,2005,267,99,168
Zacatecas,No especificado,2010,253,102,151
Zacatecas,No especificado,2020,1858,917,941
Zacatecas,95 a 99 años,1990,693,322,371
Zacatecas,95 a 99 años,1995,933,430,503
Zacatecas,95 a 99 años,2000,2522,1162,1360
Zacatecas,95 a 99 años,2005,2572,1195,1377
Zacatecas,95 a 99 años,2010,2832,1296,1536
Zacatecas,95 a 99 años,2020,1723,738,985
Zacatecas,90 a 94 años,1990,1915,903,1012
Zacatecas,90 a 94 años,1995,2355,1165,1190
Zacatecas,90 a 94 años,2000,5780,2746,3034
Zacatecas,90 a 94 años,2005,6230,2993,3237
Zacatecas,90 a 94 años,2010,8507,4152,4355
Zacatecas,90 a 94 años,2020,4569,2160,2409
Zacatecas,85 a 89 años,1990,5132,2623,2509
Zacatecas,85 a 89 años,1995,5504,2775,2729
Zacatecas,85 a 89 años,2000,8519,4126,4393
Zacatecas,85 a 89 años,2005,12212,5997,6215
Zacatecas,85 a 89 años,2010,13941,6868,7073
Zacatecas,85 a 89 años,2020,10975,5233,5742
Zacatecas,80 a 84 años,1990,8790,4280,4510
Zacatecas,80 a 84 años,1995,8671,4219,4452
Zacatecas,80 a 84 años,2000,15781,8007,7774
Zacatecas,80 a 84 años,2005,18430,9424,9006
Zacatecas,80 a 84 años,2010,21022,10463,10559
Zacatecas,80 a 84 años,2020,18058,8641,9417
Zacatecas,75 a 79 años,1990,11582,5862,5720
Zacatecas,75 a 79 años,1995,11604,5840,5764
Zacatecas,75 a 79 años,2000,22021,11141,10880
Zacatecas,75 a 79 años,2005,24798,12239,12559
Zacatecas,75 a 79 años,2010,29225,14135,15090
Zacatecas,75 a 79 años,2020,26357,13015,13342
Zacatecas,70 a 74 años,1990,14244,7124,7120
Zacatecas,70 a 74 años,1995,19451,9945,9506
Zacatecas,70 a 74 años,2000,27493,13503,13990
Zacatecas,70 a 74 años,2005,30335,14844,15491
Zacatecas,70 a 74 años,2010,34106,16684,17422
Zacatecas,70 a 74 años,2020,35100,17080,18020
Zacatecas,65 a 69 años,1990,20901,10476,10425
Zacatecas,65 a 69 años,1995,24586,12218,12368
Zacatecas,65 a 69 años,2000,33857,16374,17483
Zacatecas,65 a 69 años,2005,37993,18206,19787
Zacatecas,65 a 69 años,2010,41090,19732,21358
Zacatecas,65 a 69 años,2020,44719,21507,23212
Zacatecas,60 a 64 años,1990,27796,13843,13953
Zacatecas,60 a 64 años,1995,32177,15849,16328
Zacatecas,60 a 64 años,2000,37283,18116,19167
Zacatecas,60 a 64 años,2005,40637,19586,21051
Zacatecas,60 a 64 años,2010,47741,23002,24739
Zacatecas,60 a 64 años,2020,58039,27708,30331
Zacatecas,55 a 59 años,1990,31117,15436,15681
Zacatecas,55 a 59 años,1995,34251,16837,17414
Zacatecas,55 a 59 años,2000,44565,21278,23287
Zacatecas,55 a 59 años,2005,50399,24139,26260
Zacatecas,55 a 59 años,2010,62448,29522,32926
Zacatecas,55 a 59 años,2020,69401,32945,36456
Zacatecas,50 a 54 años,1990,37307,17986,19321
Zacatecas,50 a 54 años,1995,41667,20389,21278
Zacatecas,50 a 54 años,2000,50907,24127,26780
Zacatecas,50 a 54 años,2005,62751,29454,33297
Zacatecas,50 a 54 años,2010,74010,35111,38899
Zacatecas,50 a 54 años,2020,86207,40965,45242
Zacatecas,5 a 9 años,1990,176489,89374,87115
Zacatecas,5 a 9 años,1995,171797,87400,84397
Zacatecas,5 a 9 años,2000,156356,79468,76888
Zacatecas,5 a 9 años,2005,143830,73032,70798
Zacatecas,5 a 9 años,2010,152037,77320,74717
Zacatecas,5 a 9 años,2020,155704,78441,77263
Zacatecas,45 a 49 años,1990,44527,21422,23105
Zacatecas,45 a 49 años,1995,48555,23360,25195
Zacatecas,45 a 49 años,2000,64510,30278,34232
Zacatecas,45 a 49 años,2005,76065,35796,40269
Zacatecas,45 a 49 años,2010,88979,42123,46856
Zacatecas,45 a 49 años,2020,95118,46099,49019
Zacatecas,40 a 44 años,1990,48332,22993,25339
Zacatecas,40 a 44 años,1995,55923,27009,28914
Zacatecas,40 a 44 años,2000,79770,37063,42707
Zacatecas,40 a 44 años,2005,89531,41641,47890
Zacatecas,40 a 44 años,2010,101327,48473,52854
Zacatecas,40 a 44 años,2020,102682,48739,53943
Zacatecas,35 a 39 años,1990,58426,27669,30757
Zacatecas,35 a 39 años,1995,73092,34745,38347
Zacatecas,35 a 39 años,2000,91476,41919,49557
Zacatecas,35 a 39 años,2005,97454,45183,52271
Zacatecas,35 a 39 años,2010,105427,49237,56190
Zacatecas,35 a 39 años,2020,104728,49653,55075
Zacatecas,30 a 34 años,1990,70196,32770,37426
Zacatecas,30 a 34 años,1995,84527,39772,44755
Zacatecas,30 a 34 años,2000,101757,46340,55417
Zacatecas,30 a 34 años,2005,99137,44095,55042
Zacatecas,30 a 34 años,2010,107817,50416,57401
Zacatecas,30 a 34 años,2020,114442,53586,60856
Zacatecas,25 a 29 años,1990,84807,38980,45827
Zacatecas,25 a 29 años,1995,98409,45720,52689
Zacatecas,25 a 29 años,2000,119820,53411,66409
Zacatecas,25 a 29 años,2005,112509,50280,62229
Zacatecas,25 a 29 años,2010,131079,62008,69071
Zacatecas,25 a 29 años,2020,117673,55905,61768
Zacatecas,20 a 24 años,1990,114990,52525,62465
Zacatecas,20 a 24 años,1995,126861,59278,67583
Zacatecas,20 a 24 años,2000,145464,69249,76215
Zacatecas,20 a 24 años,2005,145349,70292,75057
Zacatecas,20 a 24 años,2010,150499,75169,75330
Zacatecas,20 a 24 años,2020,130238,63289,66949
Zacatecas,15 a 19 años,1990,158599,77277,81322
Zacatecas,15 a 19 años,1995,159590,77607,81983
Zacatecas,15 a 19 años,2000,171383,86962,84421
Zacatecas,15 a 19 años,2005,156277,79335,76942
Zacatecas,15 a 19 años,2010,152154,77052,75102
Zacatecas,15 a 19 años,2020,141208,70860,70348
Zacatecas,100 años y más,1990,273,100,173
Zacatecas,100 años y más,1995,192,74,118
Zacatecas,100 años y más,2000,1331,589,742
Zacatecas,100 años y más,2005,1188,517,671
Zacatecas,100 años y más,2010,1176,526,650
Zacatecas,100 años y más,2020,239,102,137
Zacatecas,10 a 14 años,1990,184782,92729,92053
Zacatecas,10 a 14 años,1995,173536,87970,85566
Zacatecas,10 a 14 años,2000,164225,83334,80891
Zacatecas,10 a 14 años,2005,148813,75506,73307
Zacatecas,10 a 14 años,2010,151780,76898,74882
Zacatecas,10 a 14 años,2020,151355,76912,74443
Zacatecas,0 a 4 años,1990,172330,87473,84857
Zacatecas,0 a 4 años,1995,160610,81928,78682
Zacatecas,0 a 4 años,2000,1353610,653583,700027
Zacatecas,0 a 4 años,2005,1367692,659333,708359
Zacatecas,0 a 4 años,2010,1490668,726897,763771
Zacatecas,0 a 4 años,2020,151745,76563,75182